0/0/0 0/0/0 0/0/0 3/0/1 3/0/1 3/0/1 3/0/1 3/0/1 3/0/1 3/0/1 3/0/1 3/0/1 3/0/1 3/0/1 3/0/1 3/0/1 3/0/1 3/0/1 3/0/1 3/0/1 3/0/1 3/0/1 3/0/1 3/0/1 3/0/1 3/0/1 3/0/1 3/0/1 3/0/1 3/0/1 3/0/1 3/0/1 3/0/1 3/0/1 3/0/1 3/0/1 3/0/1 3/0/1 3/0/1 3/0/1 3/0/1 3/0/1 3/0/1 3/0/1 3/0/1 3/0/1 3/0/1 3/0/1 3/0/1 3/0/1 3/0/1 3/0/1 3/0/1 3/0/1 3/0/1 3/0/1 3/0/1 3/0/1 3/0/1 3/0/1 3/0/1 3/0/1 3/0/1 3/0/1 3/0/1 3/0/1 3/0/1 3/0/1 3/0/1 3/0/1 3/0/1 3/0/1 3/0/1 3/0/1 3/0/1 3/0/1 3/0/1 0/0/0 0/0/0 0/0/0
0/0/0 0/0/0 0/0/0 3/0/1 0/0/4 0/0/4 0/0/4 0/0/4 0/0/0 0/0/0 0/0/0 0/0/0 0/0/0 0/0/0 0/0/0 0/0/0 0/0/0 0/0/0 0/0/1 0/0/0 0/0/0 0/0/0 0/0/0 0/0/0 0/0/0 0/0/0 0/0/0 0/0/4 0/0/4 0/0/4 0/0/0 0/0/0 0/0/1 0/0/0 0/0/0 0/0/0 0/0/0 0/0/0 0/0/0 0/0/0 0/0/0 0/0/0 0/0/4 0/0/4 0/0/4 0/0/4 0/0/1 0/0/0 0/0/0 0/0/0 0/0/0 0/0/0 0/0/0 0/0/0 0/0/0 0/0/0 0/0/0 0/0/4 0/0/4 0/0/4 0/0/4 0/0/1 0/0/4 0/0/4 0/0/4 0/0/4 0/0/0 0/0/0 0/0/0 0/0/0 0/0/0 0/0/0 0/0/0 0/0/0 0/0/0 0/0/0 3/0/1 0/0/0 0/0/0 0/0/0
0/0/0 0/0/0 0/0/0 3/0/1 0/0/4 0/0/4 0/0/4 0/0/4 0/0/0 0/0/0 0/0/0 0/0/0 0/0/0 0/0/0 0/0/0 0/0/0 0/0/0 0/0/0 0/0/1 0/0/0 0/0/0 0/0/0 0/0/0 0/0/0 0/0/0 0/0/0 0/0/0 0/0/4 0/0/4 0/0/4 0/0/0 0/0/0 0/0/1 0/0/0 0/0/0 0/0/0 0/0/0 0/0/0 0/0/0 0/0/0 0/0/0 0/0/0 0/0/4 0/0/4 0/0/4 0/0/4 0/0/1 0/0/0 0/0/0 0/0/0 0/0/0 0/0/0 0/0/0 0/0/0 0/0/0 0/0/0 0/0/0 0/0/4 0/0/4 0/0/4 0/0/4 0/0/1 0/0/4 0/0/4 0/0/4 0/0/4 0/0/0 0/0/0 0/0/0 0/0/0 0/0/0 0/0/0 0/0/0 0/0/0 0/0/0 0/0/0 3/0/1 0/0/0 0/0/0 0/0/0
0/0/0 0/0/0 0/0/0 3/0/1 0/0/4 0/0/4 0/0/4 0/0/4 0/0/0 0/0/0 0/0/0 0/0/0 0/0/0 0/0/0 0/0/0 0/0/0 0/0/0 0/0/0 0/0/1 0/0/0 0/0/0 0/0/0 0/0/0 0/0/0 0/0/0 0/0/0 0/0/0 0/0/4 0/0/4 0/0/4 0/0/0 0/0/0 0/0/1 0/0/0 0/0/0 0/0/0 0/0/0 0/0/0 0/0/0 0/0/0 0/0/0 0/0/0 0/0/4 0/0/4 0/0/4 0/0/4 0/0/1 0/0/0 0/0/0 0/0/0 0/0/0 0/0/0 0/0/0 0/0/0 0/0/0 0/0/0 0/0/0 0/0/0 0/0/0 0/0/0 0/0/0 0/0/1 0/0/0 0/0/0 0/0/0 0/0/0 0/0/0 0/0/0 0/0/0 0/0/0 0/0/0 0/0/0 0/0/0 0/0/0 0/0/0 0/0/0 3/0/1 0/0/0 0/0/0 0/0/0
0/0/0 0/0/0 0/0/0 3/0/1 0/0/0 0/0/0 0/0/0 0/0/0 0/0/0 0/0/0 0/0/0 0/0/0 0/0/0 0/0/0 0/0/0 0/0/0 0/0/0 0/0/0 0/0/1 0/0/0 0/0/0 0/0/0 0/0/0 0/0/0 0/0/0 0/0/0 0/0/0 0/0/4 0/0/4 0/0/4 0/0/0 0/0/0 0/0/1 0/0/0 0/0/0 0/0/0 0/0/0 0/0/0 0/0/0 0/0/0 0/0/0 0/0/0 0/0/0 0/0/0 0/0/0 0/0/0 0/0/1 0/0/0 0/0/0 0/0/0 0/0/0 0/0/0 0/0/0 0/0/0 0/0/0 0/0/0 0/0/0 0/0/0 0/0/0 0/0/0 0/0/0 0/0/1 0/0/0 0/0/0 0/0/0 0/0/0 0/0/0 0/0/0 0/0/0 0/0/0 0/0/0 0/0/0 0/0/0 0/0/0 0/0/0 0/0/0 3/0/1 0/0/0 0/0/0 0/0/0
0/0/0 0/0/0 0/0/0 3/0/1 0/0/0 0/0/0 0/0/0 0/0/0 0/0/0 0/0/0 0/0/0 0/0/0 0/0/3 0/0/0 0/0/0 0/0/0 0/0/0 0/0/0 0/0/1 0/0/0 0/0/0 0/0/0 0/0/0 0/0/0 0/0/0 0/0/3 0/0/0 0/0/3 0/0/0 0/0/3 0/0/0 0/0/0 0/0/1 0/0/0 0/0/0 0/0/0 0/0/0 0/0/0 0/0/0 0/0/0 0/0/0 0/0/0 0/0/3 0/0/3 0/0/0 0/0/0 0/0/1 0/0/0 0/0/0 0/0/0 0/0/0 0/0/0 0/0/0 0/0/3 0/0/3 0/0/3 0/0/0 0/0/0 0/0/0 0/0/0 0/0/0 0/0/1 0/0/3 0/0/0 0/0/3 0/0/3 0/0/0 0/0/0 0/0/0 0/0/0 0/0/0 0/0/0 0/0/0 0/0/0 0/0/0 0/0/0 3/0/1 0/0/0 0/0/0 0/0/0
0/0/0 0/0/0 0/0/0 3/0/1 0/0/1 0/0/1 0/0/1 0/0/1 0/0/1 0/0/1 0/0/1 0/0/1 0/0/1 0/0/1 0/0/1 0/0/0 0/0/0 0/0/0 0/0/1 0/0/0 0/0/0 0/0/0 0/0/0 0/0/1 0/0/1 0/0/1 0/0/1 0/0/1 0/0/1 0/0/1 0/0/1 0/0/1 0/0/1 0/0/0 0/0/0 0/0/0 0/0/1 0/0/1 0/0/1 0/0/1 0/0/1 0/0/1 0/0/1 0/0/1 0/0/1 0/0/1 0/0/1 0/0/0 0/0/0 0/0/0 0/0/1 0/0/1 0/0/1 0/0/1 0/0/1 0/0/1 0/0/1 0/0/1 0/0/1 0/0/1 0/0/1 0/0/1 0/0/1 0/0/1 0/0/1 0/0/1 0/0/1 0/0/1 0/0/1 0/0/1 0/0/1 0/0/1 0/0/0 0/0/0 0/0/0 0/0/0 3/0/1 0/0/0 0/0/0 0/0/0
0/0/0 0/0/0 0/0/0 3/0/1 0/0/0 0/0/0 0/0/0 0/0/0 0/0/0 0/0/0 0/0/0 0/0/0 0/0/0 0/0/0 0/0/0 0/0/0 0/0/0 0/0/0 0/0/0 0/0/0 0/0/0 0/0/0 0/0/0 0/0/0 0/0/0 0/0/0 0/0/0 0/0/0 0/0/0 0/0/0 0/0/0 0/0/0 0/0/0 0/0/0 0/0/0 0/0/0 0/0/0 0/0/0 0/0/0 0/0/0 0/0/0 0/0/0 0/0/0 0/0/0 0/0/0 0/0/0 0/0/0 0/0/0 0/0/0 0/0/0 0/0/0 0/0/0 0/0/0 0/0/0 0/0/0 0/0/0 0/0/0 0/0/0 0/0/0 0/0/0 0/0/0 0/0/0 0/0/0 0/0/0 0/0/0 0/0/0 0/0/0 0/0/0 0/0/0 0/0/0 0/0/0 0/0/0 0/0/0 0/0/0 0/0/0 0/0/0 3/0/1 0/0/0 0/0/0 0/0/0
0/0/0 0/0/0 0/0/0 3/0/1 0/0/0 0/0/0 0/0/0 0/0/0 0/0/0 0/0/0 0/0/0 0/0/0 0/0/0 0/0/0 0/0/0 0/0/0 0/0/0 0/0/0 0/0/0 0/0/0 0/0/0 0/0/0 0/0/0 0/0/0 0/0/0 0/0/0 0/0/0 0/0/0 0/0/0 0/0/0 0/0/0 0/0/0 0/0/0 0/0/0 0/0/0 0/0/0 0/0/0 0/0/0 0/0/0 0/0/0 0/0/0 0/0/0 0/0/0 0/0/0 0/0/0 0/0/0 0/0/0 0/0/0 0/0/0 0/0/0 0/0/0 0/0/0 0/0/0 0/0/0 0/0/0 0/0/0 0/0/0 0/0/0 0/0/0 0/0/0 0/0/0 0/0/0 0/0/0 0/0/0 0/0/0 0/0/0 0/0/0 0/0/0 0/0/0 0/0/0 0/0/0 0/0/0 0/0/0 0/0/0 0/0/0 0/0/0 3/0/1 0/0/0 0/0/0 0/0/0
0/0/0 0/0/0 0/0/0 3/0/1 0/0/0 0/0/0 0/0/0 0/0/0 0/0/0 0/0/0 0/0/0 0/0/0 0/0/0 0/0/0 0/0/0 0/0/0 0/0/0 0/0/0 0/0/0 0/0/0 0/0/0 0/0/0 0/0/0 0/0/0 0/0/0 0/0/0 0/0/0 0/0/0 0/0/0 0/0/0 0/0/0 0/0/0 0/0/0 0/0/0 0/0/0 0/0/0 0/0/0 0/0/0 0/0/0 0/0/0 0/0/0 0/0/0 0/0/0 0/0/0 0/0/0 0/0/0 0/0/0 0/0/0 0/0/0 0/0/0 0/0/0 0/0/0 0/0/0 0/0/0 0/0/0 0/0/0 0/0/0 0/0/0 0/0/0 0/0/0 0/0/0 0/0/0 0/0/0 0/0/0 0/0/0 0/0/0 0/0/0 0/0/0 0/0/0 0/0/0 0/0/0 0/0/0 0/0/0 0/0/0 0/0/0 0/0/0 3/0/1 0/0/0 0/0/0 0/0/0
0/0/0 0/0/0 0/0/0 3/0/1 0/0/0 0/0/0 0/0/0 0/0/0 0/0/0 0/0/0 0/0/0 0/0/0 0/0/0 0/0/0 0/0/0 0/0/0 0/0/0 0/0/0 0/0/0 3/0/1 3/0/1 3/0/1 3/0/1 3/0/1 3/0/1 3/0/1 3/0/1 3/0/1 3/0/1 3/0/1 3/0/1 3/0/1 3/0/1 3/0/1 3/0/1 3/0/1 3/0/1 3/0/1 3/0/1 3/0/1 3/0/1 3/0/1 3/0/1 3/0/1 3/0/1 3/0/1 3/0/1 3/0/1 3/0/1 3/0/1 3/0/1 3/0/1 3/0/1 3/0/1 3/0/1 3/0/1 3/0/1 3/0/1 3/0/1 3/0/1 3/0/1 3/0/1 0/0/0 0/0/0 0/0/0 0/0/0 0/0/0 0/0/0 0/0/0 0/0/0 0/0/0 0/0/0 0/0/0 0/0/0 0/0/0 0/0/0 3/0/1 0/0/0 0/0/0 0/0/0
0/0/0 0/0/0 0/0/0 3/0/1 0/0/1 0/0/1 0/0/1 0/0/1 0/0/1 0/0/1 0/0/1 0/0/1 0/0/1 0/0/1 0/0/0 0/0/0 0/0/0 0/0/0 0/0/0 3/0/1 0/0/0 0/0/0 0/0/0 0/0/0 0/0/0 0/0/0 0/0/0 0/0/0 0/0/0 0/0/0 0/0/0 0/0/0 0/0/3 0/0/0 0/0/0 0/0/0 0/0/0 0/0/0 0/0/0 0/0/0 0/0/0 0/0/0 0/0/0 0/0/0 0/0/0 0/0/0 0/0/0 0/0/0 0/0/0 0/0/0 0/0/0 0/0/0 0/0/0 0/0/0 0/0/0 0/0/0 0/0/0 0/0/3 0/0/3 0/0/3 0/0/3 3/0/1 0/0/0 0/0/0 0/0/0 0/0/0 0/0/1 0/0/1 0/0/1 0/0/1 0/0/1 0/0/1 0/0/1 0/0/1 0/0/1 0/0/1 3/0/1 0/0/0 0/0/0 0/0/0
0/0/0 0/0/0 0/0/0 3/0/1 0/0/0 0/0/0 0/0/0 0/0/0 0/0/3 0/0/3 0/0/0 0/0/0 0/0/0 0/0/1 0/0/0 0/0/0 0/0/0 0/0/0 0/0/0 3/0/1 0/0/0 0/0/0 0/0/0 0/0/0 0/0/0 0/0/0 0/0/0 0/0/0 0/0/0 0/0/0 0/0/0 0/0/0 0/0/0 0/0/0 0/0/3 0/0/3 0/0/0 0/0/0 0/0/3 0/0/0 0/0/0 0/0/0 0/0/3 0/0/3 0/0/0 0/0/0 0/0/3 0/0/0 0/0/0 0/0/3 0/0/0 0/0/0 0/0/3 0/0/0 0/0/0 0/0/0 0/0/0 0/0/3 0/0/3 0/0/3 0/0/3 3/0/1 0/0/0 0/0/0 0/0/0 0/0/0 0/0/1 0/0/3 0/0/0 0/0/0 0/0/0 0/0/4 0/0/4 0/0/4 0/0/4 0/0/4 3/0/1 0/0/0 0/0/0 0/0/0
0/0/0 0/0/0 0/0/0 3/0/1 0/0/0 0/0/0 0/0/0 0/0/0 0/0/0 0/0/0 0/0/0 0/0/0 0/0/0 0/0/1 0/0/0 0/0/0 0/0/0 0/0/0 0/0/0 3/0/1 0/0/0 0/0/0 0/0/0 0/0/0 0/0/0 0/0/0 0/0/0 0/0/0 0/0/0 0/0/0 0/0/0 0/0/0 0/0/0 0/0/0 0/0/0 0/0/0 0/0/0 0/0/0 0/0/0 0/0/0 0/0/0 0/0/0 0/0/0 0/0/0 0/0/0 0/0/0 0/0/0 0/0/0 0/0/0 0/0/0 0/0/0 0/0/0 0/0/0 0/0/0 0/0/0 0/0/3 0/0/0 0/0/3 0/0/3 0/0/3 0/0/3 3/0/1 0/0/0 0/0/0 0/0/0 0/0/0 0/0/1 0/0/3 0/0/0 0/0/0 0/0/0 0/0/4 0/0/4 0/0/4 0/0/4 0/0/4 3/0/1 0/0/0 0/0/0 0/0/0
0/0/0 0/0/0 0/0/0 3/0/1 0/0/0 0/0/0 0/0/0 0/0/0 0/0/0 0/0/0 0/0/0 0/0/0 0/0/0 0/0/0 0/0/0 0/0/0 0/0/0 0/0/0 0/0/0 3/0/1 0/0/0 0/0/0 0/0/0 0/0/0 0/0/0 0/0/0 0/0/0 0/0/0 0/0/0 0/0/0 0/0/0 0/0/0 0/0/0 0/0/0 0/0/0 0/0/0 0/0/0 0/0/0 0/0/0 0/0/0 0/0/0 0/0/0 0/0/0 0/0/0 0/0/0 0/0/0 0/0/0 0/0/0 0/0/0 0/0/0 0/0/0 0/0/3 0/0/0 0/0/3 0/0/3 0/0/0 0/0/0 0/0/0 0/0/0 0/0/0 0/0/0 3/0/1 0/0/0 0/0/0 0/0/0 0/0/0 0/0/1 0/0/3 0/0/0 0/0/0 0/0/0 0/0/4 0/0/4 0/0/4 0/0/4 0/0/4 3/0/1 0/0/0 0/0/0 0/0/0
0/0/0 0/0/0 0/0/0 3/0/1 0/0/0 0/0/0 0/0/0 0/0/0 0/0/0 0/0/0 0/0/0 0/0/0 0/0/0 0/0/0 0/0/0 0/0/0 0/0/0 0/0/0 0/0/0 3/0/1 0/0/0 0/0/0 0/0/0 0/0/0 0/0/0 0/0/0 0/0/0 0/0/0 0/0/0 0/0/0 0/0/0 0/0/0 0/0/0 0/0/0 0/0/0 0/0/0 0/0/0 0/0/0 0/0/0 0/0/0 0/0/0 0/0/0 0/0/0 0/0/0 0/0/0 0/0/0 0/0/0 0/0/0 0/0/0 0/0/0 0/0/0 0/0/3 0/0/0 0/0/3 0/0/0 0/0/0 0/0/0 0/0/0 0/0/0 0/0/0 0/0/0 3/0/1 0/0/0 0/0/0 0/0/0 0/0/0 0/0/1 0/0/0 0/0/0 0/0/0 0/0/0 0/0/0 0/0/0 0/0/0 0/0/0 0/0/0 3/0/1 0/0/0 0/0/0 0/0/0
0/0/0 0/0/0 0/0/0 3/0/1 0/0/0 0/0/0 0/0/0 0/0/0 0/0/0 0/0/0 0/0/4 0/0/4 0/0/4 0/0/1 0/0/0 0/0/0 0/0/0 0/0/0 0/0/0 3/0/1 0/0/0 0/0/0 0/0/0 0/0/0 0/0/0 0/0/0 0/0/0 0/0/0 0/0/0 0/0/0 0/0/0 0/0/0 0/0/0 0/0/0 0/0/0 0/0/0 0/0/0 0/0/0 0/0/0 0/0/0 0/0/0 0/0/0 0/0/0 0/0/0 0/0/0 0/0/0 0/0/0 0/0/0 0/0/0 0/0/0 0/0/0 0/0/3 0/0/3 0/0/3 0/0/0 0/0/3 0/0/0 0/0/0 0/0/0 0/0/0 0/0/0 3/0/1 0/0/0 0/0/0 0/0/0 0/0/0 0/0/1 0/0/0 0/0/0 0/0/0 0/0/0 0/0/0 0/0/0 0/0/0 0/0/0 0/0/0 3/0/1 0/0/0 0/0/0 0/0/0
0/0/0 0/0/0 0/0/0 3/0/1 0/0/0 0/0/0 0/0/0 0/0/0 0/0/0 0/0/0 0/0/4 0/0/4 0/0/4 0/0/1 0/0/0 0/0/0 0/0/0 0/0/0 0/0/0 3/0/1 0/0/0 0/0/0 0/0/0 0/0/3 0/0/0 0/0/3 0/0/3 0/0/0 0/0/3 0/0/0 0/0/0 0/0/0 0/0/0 0/0/0 0/0/0 0/0/0 0/0/0 0/0/0 0/0/0 0/0/0 0/0/0 0/0/0 0/0/0 0/0/0 0/0/0 0/0/0 0/0/0 0/0/0 0/0/0 0/0/0 0/0/0 0/0/0 0/0/0 0/0/3 0/0/3 0/0/3 0/0/0 0/0/0 0/0/0 0/0/0 0/0/0 3/0/1 0/0/0 0/0/0 0/0/0 0/0/0 0/0/0 0/0/0 0/0/0 0/0/0 0/0/0 0/0/0 0/0/0 0/0/0 0/0/0 0/0/0 3/0/1 0/0/0 0/0/0 0/0/0
0/0/0 0/0/0 0/0/0 3/0/1 0/0/0 0/0/0 0/0/0 0/0/0 0/0/0 0/0/0 0/0/4 0/0/4 0/0/4 0/0/1 0/0/0 0/0/0 0/0/0 0/0/0 0/0/0 3/0/1 0/0/0 0/0/0 0/0/0 0/0/0 0/0/3 0/0/0 0/0/0 0/0/3 0/0/0 0/0/3 0/0/0 0/0/0 0/0/0 0/0/0 0/0/0 0/0/0 0/0/0 0/0/0 0/0/0 0/0/0 0/0/0 0/0/0 0/0/0 0/0/0 0/0/0 0/0/0 0/0/0 0/0/0 0/0/0 0/0/0 0/0/0 0/0/0 0/0/3 0/0/0 0/0/0 0/0/0 0/0/0 0/0/0 0/0/0 0/0/0 0/0/0 3/0/1 0/0/0 0/0/0 0/0/0 0/0/0 0/0/0 0/0/0 0/0/0 0/0/0 0/0/0 0/0/0 0/0/0 0/0/0 0/0/0 0/0/0 3/0/1 0/0/0 0/0/0 0/0/0
0/0/0 0/0/0 0/0/0 3/0/1 0/0/0 0/0/0 0/0/0 0/0/0 0/0/0 0/0/0 0/0/4 0/0/4 0/0/4 0/0/1 0/0/0 0/0/0 0/0/0 0/0/0 0/0/0 3/0/1 0/0/0 0/0/0 0/0/0 0/0/3 0/0/0 0/0/0 0/0/3 0/0/0 0/0/3 0/0/3 0/0/0 0/0/0 0/0/0 0/0/0 0/0/0 0/0/0 0/0/0 0/0/0 0/0/0 0/0/0 0/0/0 0/0/0 0/0/0 0/0/0 0/0/0 0/0/0 0/0/0 0/0/0 0/0/0 0/0/0 0/0/0 0/0/0 0/0/0 0/0/3 0/0/0 0/0/0 0/0/0 0/0/0 0/0/0 0/0/0 0/0/0 3/0/1 0/0/0 0/0/0 0/0/0 0/0/0 0/0/0 0/0/0 0/0/0 0/0/0 0/0/0 0/0/0 0/0/0 0/0/0 0/0/0 0/0/0 3/0/1 0/0/0 0/0/0 0/0/0
0/0/0 0/0/0 0/0/0 3/0/1 0/0/1 0/0/1 0/0/1 0/0/1 0/0/1 0/0/1 0/0/1 0/0/1 0/0/1 0/0/1 0/0/0 0/0/0 0/0/0 0/0/0 0/0/0 3/0/1 0/0/0 0/0/0 0/0/0 0/0/0 0/0/0 0/0/0 0/0/0 0/0/0 0/0/0 0/0/0 0/0/0 0/0/0 0/0/0 0/0/0 0/0/0 0/0/0 0/0/0 0/0/0 0/0/0 0/0/0 0/0/0 0/0/0 0/0/0 0/0/0 0/0/3 0/0/3 0/0/3 0/0/3 0/0/0 0/0/0 0/0/0 0/0/0 0/0/3 0/0/3 0/0/3 0/0/3 0/0/0 0/0/0 0/0/0 0/0/0 0/0/0 3/0/1 0/0/0 0/0/0 0/0/0 0/0/0 0/0/1 0/0/1 0/0/1 0/0/1 0/0/1 0/0/1 0/0/1 0/0/1 0/0/1 0/0/1 3/0/1 0/0/0 0/0/0 0/0/0
0/0/0 0/0/0 0/0/0 3/0/1 0/0/0 0/0/0 0/0/0 0/0/0 0/0/0 0/0/0 0/0/0 0/0/0 0/0/0 0/0/0 0/0/0 0/0/0 0/0/0 0/0/0 0/0/0 3/0/1 0/0/0 0/0/0 0/0/0 0/0/0 0/0/3 0/0/0 0/0/0 0/0/0 0/0/0 0/0/3 0/0/0 0/0/0 0/0/0 0/0/0 0/0/0 0/0/0 0/0/0 0/0/0 0/0/0 0/0/0 0/0/0 0/0/0 0/0/0 0/0/0 0/0/3 0/0/3 0/0/3 0/0/3 0/0/0 0/0/0 0/0/0 0/0/0 0/0/3 0/0/3 0/0/3 0/0/3 0/0/0 0/0/0 0/0/0 0/0/0 0/0/0 3/0/1 0/0/0 0/0/0 0/0/0 0/0/0 0/0/0 0/0/0 0/0/0 0/0/0 0/0/4 0/0/4 0/0/4 0/0/4 0/0/4 0/0/4 3/0/1 0/0/0 0/0/0 0/0/0
0/0/0 0/0/0 0/0/0 3/0/1 0/0/0 0/0/0 0/0/0 0/0/0 0/0/0 0/0/0 0/0/0 0/0/0 0/0/0 0/0/0 0/0/0 0/0/0 0/0/0 0/0/0 0/0/0 3/0/1 0/0/0 0/0/0 0/0/3 0/0/0 0/0/0 0/0/3 0/0/0 0/0/3 0/0/0 0/0/0 0/0/0 0/0/0 0/0/0 0/0/0 0/0/0 0/0/0 0/0/0 0/0/0 0/0/0 0/0/0 0/0/0 0/0/0 0/0/0 0/0/3 0/0/3 0/0/3 0/0/3 0/0/3 0/0/0 0/0/0 0/0/0 0/0/0 0/0/3 0/0/0 0/0/3 0/0/3 0/0/0 0/0/0 0/0/0 0/0/0 0/0/0 3/0/1 0/0/0 0/0/0 0/0/0 0/0/0 0/0/0 0/0/0 0/0/0 0/0/0 0/0/0 0/0/4 0/0/4 0/0/4 0/0/4 0/0/4 3/0/1 0/0/0 0/0/0 0/0/0
0/0/0 0/0/0 0/0/0 3/0/1 0/0/0 0/0/0 0/0/0 0/0/0 0/0/0 0/0/0 0/0/4 0/0/4 0/0/4 0/0/1 0/0/0 0/0/0 0/0/0 0/0/0 0/0/0 3/0/1 0/0/0 0/0/0 0/0/0 0/0/0 0/0/3 0/0/0 0/0/0 0/0/0 0/0/0 0/0/0 0/0/0 0/0/0 0/0/0 0/0/0 0/0/0 0/0/0 0/0/0 0/0/0 0/0/0 0/0/0 0/0/0 0/0/0 0/0/0 0/0/0 0/0/0 0/0/0 0/0/0 0/0/0 0/0/0 0/0/0 0/0/0 0/0/0 0/0/0 0/0/0 0/0/0 0/0/0 0/0/0 0/0/0 0/0/0 0/0/0 0/0/0 3/0/1 0/0/0 0/0/0 0/0/0 0/0/0 0/0/0 0/0/0 0/0/0 0/0/0 0/0/0 0/0/4 0/0/4 0/0/4 0/0/4 0/0/4 3/0/1 0/0/0 0/0/0 0/0/0
0/0/0 0/0/0 0/0/0 3/0/1 0/0/0 0/0/0 0/0/0 0/0/0 0/0/0 0/0/0 0/0/4 0/0/4 0/0/4 0/0/1 0/0/0 0/0/0 0/0/0 0/0/0 0/0/0 3/0/1 0/0/0 0/0/0 0/0/0 0/0/0 0/0/0 0/0/0 0/0/3 0/0/0 0/0/0 0/0/3 0/0/0 0/0/0 0/0/0 0/0/0 0/0/0 0/0/0 0/0/0 0/0/0 0/0/0 0/0/0 0/0/0 0/0/0 0/0/0 0/0/0 0/0/0 0/0/0 0/0/0 0/0/0 0/0/0 0/0/0 0/0/0 0/0/0 0/0/0 0/0/3 0/0/0 0/0/3 0/0/0 0/0/0 0/0/0 0/0/0 0/0/0 3/0/1 0/0/0 0/0/0 0/0/0 0/0/0 0/0/1 0/0/3 0/0/0 0/0/0 0/0/0 0/0/0 0/0/0 0/0/0 0/0/0 0/0/0 3/0/1 0/0/0 0/0/0 0/0/0
0/0/0 0/0/0 0/0/0 3/0/1 0/0/0 0/0/0 0/0/0 0/0/0 0/0/0 0/0/0 0/0/4 0/0/4 0/0/4 0/0/1 0/0/0 0/0/0 0/0/0 0/0/0 0/0/0 3/0/1 0/0/0 0/0/0 0/0/0 0/0/0 0/0/0 0/0/0 0/0/0 0/0/0 0/0/0 0/0/0 0/0/0 0/0/0 0/0/0 0/0/0 0/0/0 0/0/0 0/0/0 0/0/0 0/0/0 0/0/0 0/0/0 0/0/0 0/0/0 0/0/0 0/0/0 0/0/0 0/0/0 0/0/0 0/0/0 0/0/0 0/0/0 0/0/0 0/0/0 0/0/0 0/0/0 0/0/0 0/0/0 0/0/0 0/0/0 0/0/0 0/0/0 3/0/1 0/0/0 0/0/0 0/0/0 0/0/0 0/0/1 0/0/3 0/0/0 0/0/0 0/0/0 0/0/0 0/0/0 0/0/0 0/0/0 0/0/0 3/0/1 0/0/0 0/0/0 0/0/0
0/0/0 0/0/0 0/0/0 3/0/1 0/0/0 0/0/0 0/0/0 0/0/0 0/0/0 0/0/0 0/0/4 0/0/4 0/0/4 0/0/1 0/0/0 0/0/0 0/0/0 0/0/0 0/0/0 3/0/1 0/0/0 0/0/0 0/0/0 0/0/0 0/0/0 0/0/0 0/0/0 0/0/0 0/0/0 0/0/0 0/0/0 0/0/0 0/0/0 0/0/0 0/0/0 0/0/0 0/0/0 0/0/0 0/0/0 0/0/0 0/0/0 0/0/0 0/0/0 0/0/0 0/0/0 0/0/0 0/0/0 0/0/0 0/0/0 0/0/0 0/0/0 0/0/0 0/0/0 0/0/0 0/0/0 0/0/0 0/0/0 0/0/0 0/0/0 0/0/0 0/0/0 3/0/1 0/0/0 0/0/0 0/0/0 0/0/0 0/0/1 0/0/3 0/0/0 0/0/0 0/0/0 0/0/0 0/0/0 0/0/0 0/0/0 0/0/0 3/0/1 0/0/0 0/0/0 0/0/0
0/0/0 0/0/0 0/0/0 3/0/1 0/0/0 0/0/0 0/0/0 0/0/3 0/0/0 0/0/3 0/0/4 0/0/4 0/0/4 0/0/1 0/0/0 0/0/0 0/0/0 0/0/0 0/0/0 3/0/1 0/0/0 0/0/0 0/0/0 0/0/0 0/0/0 0/0/0 0/0/0 0/0/0 0/0/0 0/0/0 0/0/0 0/0/0 0/0/0 0/0/0 0/0/0 0/0/0 0/0/0 0/0/0 0/0/0 0/0/0 0/0/0 0/0/0 0/0/0 0/0/0 0/0/0 0/0/0 0/0/0 0/0/0 0/0/0 0/0/0 0/0/0 0/0/0 0/0/0 0/0/0 0/0/0 0/0/0 0/0/0 0/0/0 0/0/0 0/0/0 0/0/0 3/0/1 0/0/0 0/0/0 0/0/0 0/0/0 0/0/1 0/0/0 0/0/0 0/0/0 0/0/0 0/0/0 0/0/0 0/0/0 0/0/0 0/0/0 3/0/1 0/0/0 0/0/0 0/0/0
0/0/0 0/0/0 0/0/0 3/0/1 0/0/1 0/0/1 0/0/1 0/0/1 0/0/1 0/0/1 0/0/1 0/0/1 0/0/1 0/0/1 0/0/0 0/0/0 0/0/0 0/0/0 0/0/0 3/0/1 3/0/1 3/0/1 3/0/1 3/0/1 3/0/1 3/0/1 3/0/1 3/0/1 3/0/1 3/0/1 3/0/1 3/0/1 3/0/1 3/0/1 3/0/1 3/0/1 3/0/1 3/0/1 3/0/1 3/0/1 3/0/1 3/0/1 3/0/1 3/0/1 3/0/1 3/0/1 3/0/1 3/0/1 3/0/1 3/0/1 3/0/1 3/0/1 3/0/1 3/0/1 3/0/2 3/0/2 3/0/2 3/0/2 3/0/2 3/0/1 3/0/1 3/0/1 0/0/0 0/0/0 0/0/0 0/0/0 0/0/1 0/0/1 0/0/1 0/0/1 0/0/1 0/0/1 0/0/1 0/0/1 0/0/1 0/0/1 3/0/1 0/0/0 0/0/0 0/0/0
0/0/0 0/0/0 0/0/0 3/0/1 0/0/0 0/0/0 0/0/0 0/0/0 0/0/0 0/0/0 0/0/0 0/0/0 0/0/0 0/0/0 0/0/0 0/0/0 0/0/0 0/0/0 0/0/0 0/0/0 0/0/0 0/0/0 0/0/0 0/0/0 0/0/0 0/0/0 0/0/0 0/0/0 0/0/0 0/0/0 0/0/0 0/0/0 0/0/0 0/0/0 0/0/0 0/0/0 0/0/0 0/0/0 0/0/0 0/0/0 0/0/0 0/0/0 0/0/0 0/0/0 0/0/0 0/0/0 0/0/0 0/0/0 0/0/0 0/0/0 0/0/0 0/0/0 0/0/0 0/0/0 0/0/0 0/0/0 0/0/0 0/0/0 0/0/0 0/0/0 0/0/0 0/0/0 0/0/0 0/0/0 0/0/0 0/0/0 0/0/0 0/0/0 0/0/0 0/0/0 0/0/0 0/0/0 0/0/0 0/0/0 0/0/0 0/0/0 3/0/1 0/0/0 0/0/0 0/0/0
0/0/0 0/0/0 0/0/0 3/0/1 0/0/0 0/0/0 0/0/0 0/0/0 0/0/0 0/0/0 0/0/0 0/0/0 0/0/0 0/0/0 0/0/0 0/0/0 0/0/0 0/0/0 0/0/0 0/0/0 0/0/0 0/0/0 0/0/0 0/0/0 0/0/0 0/0/0 0/0/0 0/0/0 0/0/0 0/0/0 0/0/0 0/0/0 0/0/0 0/0/0 0/0/0 0/0/0 0/0/0 0/0/0 0/0/0 0/0/0 0/0/0 0/0/0 0/0/0 0/0/0 0/0/0 0/0/0 0/0/0 0/0/0 0/0/0 0/0/0 0/0/0 0/0/0 0/0/0 0/0/0 0/0/0 0/0/0 0/0/0 0/0/0 0/0/0 0/0/0 0/0/0 0/0/0 0/0/0 0/0/0 0/0/0 0/0/0 0/0/0 0/0/0 0/0/0 0/0/0 0/0/0 0/0/0 0/0/0 0/0/0 0/0/0 0/0/0 3/0/1 0/0/0 0/0/0 0/0/0
0/0/0 0/0/0 0/0/0 3/0/1 0/0/0 0/0/0 0/0/0 0/0/0 0/0/0 0/0/0 0/0/0 0/0/0 0/0/0 0/0/0 0/0/0 0/0/0 0/0/0 0/0/0 0/0/0 0/0/0 0/0/0 0/0/0 0/0/0 0/0/0 0/0/0 0/0/0 0/0/0 0/0/0 0/0/0 0/0/0 0/0/0 0/0/0 0/0/0 0/0/0 0/0/0 0/0/0 0/0/0 0/0/0 0/0/0 0/0/0 0/0/0 0/0/0 0/0/0 0/0/0 0/0/0 0/0/0 0/0/0 0/0/0 0/0/0 0/0/0 0/0/0 0/0/0 0/0/0 0/0/0 0/0/0 0/0/0 0/0/0 0/0/0 0/0/0 0/0/0 0/0/0 0/0/0 0/0/0 0/0/0 0/0/0 0/0/0 0/0/0 0/0/0 0/0/0 0/0/0 0/0/0 0/0/0 0/0/0 0/0/0 0/0/0 0/0/0 3/0/1 0/0/0 0/0/0 0/0/0
0/0/0 0/0/0 0/0/0 3/0/1 0/0/1 0/0/1 0/0/1 0/0/1 0/0/1 0/0/1 0/0/1 0/0/1 0/0/1 0/0/1 0/0/0 0/0/0 0/0/0 0/0/1 0/0/0 0/0/0 0/0/0 0/0/1 0/0/1 0/0/1 0/0/1 0/0/1 0/0/1 0/0/1 0/0/1 0/0/1 0/0/1 0/0/1 3/0/1 3/0/1 3/0/1 3/0/1 3/0/2 3/0/2 3/0/2 3/0/2 3/0/2 3/0/2 3/0/2 3/0/1 0/0/1 0/0/1 0/0/1 0/0/1 0/0/1 0/0/1 0/0/1 0/0/1 0/0/1 0/0/1 0/0/1 0/0/1 0/0/1 0/0/1 0/0/1 0/0/0 0/0/0 0/0/0 0/0/1 0/0/0 0/0/0 0/0/0 0/0/1 0/0/1 0/0/1 0/0/1 0/0/1 0/0/1 0/0/1 0/0/1 0/0/1 0/0/1 3/0/1 0/0/0 0/0/0 0/0/0
0/0/0 0/0/0 0/0/0 3/0/1 0/0/0 0/0/0 0/0/0 0/0/0 0/0/0 0/0/3 0/0/3 0/0/3 0/0/0 0/0/0 0/0/0 0/0/0 0/0/0 0/0/1 0/0/0 0/0/0 0/0/0 0/0/0 0/0/3 0/0/3 0/0/3 0/0/0 0/0/4 0/0/4 0/0/4 0/0/4 0/0/4 0/0/4 0/0/1 0/0/0 0/0/0 0/0/0 0/0/0 0/0/0 0/0/0 0/0/0 0/0/0 0/0/0 0/0/0 0/0/0 0/0/0 0/0/1 0/0/3 0/0/3 0/0/3 0/0/0 0/0/0 0/0/0 0/0/0 0/0/0 0/0/0 0/0/0 0/0/0 0/0/0 0/0/0 0/0/0 0/0/0 0/0/0 0/0/1 0/0/0 0/0/0 0/0/0 0/0/0 0/0/3 0/0/3 0/0/3 0/0/0 0/0/0 0/0/0 0/0/0 0/0/0 0/0/0 3/0/1 0/0/0 0/0/0 0/0/0
0/0/0 0/0/0 0/0/0 3/0/1 0/0/0 0/0/0 0/0/0 0/0/0 0/0/0 0/0/0 0/0/0 0/0/0 0/0/0 0/0/4 0/0/4 0/0/4 0/0/4 0/0/1 0/0/0 0/0/0 0/0/0 0/0/0 0/0/0 0/0/0 0/0/0 0/0/0 0/0/4 0/0/4 0/0/4 0/0/4 0/0/4 0/0/4 0/0/1 0/0/0 0/0/0 0/0/0 0/0/0 0/0/0 0/0/0 0/0/0 0/0/0 0/0/0 0/0/0 0/0/0 0/0/0 0/0/1 0/0/0 0/0/0 0/0/0 0/0/0 0/0/0 0/0/0 0/0/0 0/0/0 0/0/0 0/0/0 0/0/0 0/0/0 0/0/0 0/0/0 0/0/0 0/0/0 0/0/1 0/0/0 0/0/0 0/0/0 0/0/0 0/0/0 0/0/0 0/0/0 0/0/0 0/0/0 0/0/0 0/0/0 0/0/0 0/0/0 3/0/1 0/0/0 0/0/0 0/0/0
0/0/0 0/0/0 0/0/0 3/0/1 0/0/0 0/0/0 0/0/0 0/0/0 0/0/0 0/0/0 0/0/0 0/0/0 0/0/0 0/0/4 0/0/4 0/0/4 0/0/4 0/0/1 0/0/0 0/0/0 0/0/0 0/0/0 0/0/0 0/0/0 0/0/0 0/0/0 0/0/4 0/0/4 0/0/4 0/0/4 0/0/4 0/0/4 0/0/1 0/0/0 0/0/0 0/0/0 0/0/0 0/0/0 0/0/0 0/0/0 0/0/0 0/0/0 0/0/0 0/0/0 0/0/0 0/0/1 0/0/0 0/0/0 0/0/0 0/0/0 0/0/0 0/0/0 0/0/0 0/0/0 0/0/0 0/0/0 0/0/0 0/0/0 0/0/0 0/0/0 0/0/0 0/0/0 0/0/1 0/0/0 0/0/0 0/0/0 0/0/0 0/0/0 0/0/0 0/0/0 0/0/4 0/0/4 0/0/4 0/0/0 0/0/0 0/0/0 3/0/1 0/0/0 0/0/0 0/0/0
0/0/0 0/0/0 0/0/0 3/0/1 0/0/0 0/0/0 0/0/0 0/0/0 0/0/0 0/0/0 0/0/0 0/0/0 0/0/0 0/0/4 0/0/4 0/0/4 0/0/4 0/0/1 0/0/0 0/0/0 0/0/0 0/0/0 0/0/0 0/0/0 0/0/0 0/0/0 0/0/0 0/0/0 0/0/0 0/0/0 0/0/0 0/0/0 0/0/1 0/0/0 0/0/0 0/0/0 0/0/0 0/0/0 0/0/0 0/0/0 0/0/0 0/0/0 0/0/0 0/0/0 0/0/0 0/0/1 0/0/0 0/0/0 0/0/0 0/0/0 0/0/0 0/0/0 0/0/0 0/0/0 0/0/0 0/0/0 0/0/0 0/0/4 0/0/4 0/0/4 0/0/4 0/0/4 0/0/1 0/0/0 0/0/0 0/0/0 0/0/0 0/0/0 0/0/0 0/0/0 0/0/4 0/0/4 0/0/4 0/0/0 0/0/0 0/0/0 3/0/1 0/0/0 0/0/0 0/0/0
0/0/0 0/0/0 0/0/0 3/0/1 0/0/0 0/0/0 0/0/0 0/0/0 0/0/0 0/0/0 0/0/0 0/0/0 0/0/0 0/0/4 0/0/4 0/0/4 0/0/4 0/0/1 0/0/0 0/0/0 0/0/0 0/0/0 0/0/0 0/0/0 0/0/0 0/0/0 0/0/0 0/0/0 0/0/0 0/0/0 0/0/0 0/0/0 0/0/1 0/0/0 0/0/0 0/0/0 0/0/0 0/0/0 0/0/0 0/0/0 0/0/0 0/0/0 0/0/0 0/0/0 0/0/0 0/0/1 0/0/0 0/0/0 0/0/0 0/0/0 0/0/0 0/0/0 0/0/0 0/0/0 0/0/0 0/0/0 0/0/0 0/0/4 0/0/4 0/0/4 0/0/4 0/0/4 0/0/1 0/0/0 0/0/0 0/0/0 0/0/0 0/0/0 0/0/0 0/0/0 0/0/4 0/0/4 0/0/4 0/0/0 0/0/0 0/0/0 3/0/1 0/0/0 0/0/0 0/0/0
0/0/0 0/0/0 0/0/0 3/0/1 0/0/0 0/0/0 0/0/0 0/0/0 0/0/0 0/0/0 0/0/0 0/0/0 0/0/0 0/0/4 0/0/4 0/0/4 0/0/4 0/0/1 0/0/0 0/0/0 0/0/0 0/0/0 0/0/0 0/0/0 0/0/0 0/0/0 0/0/0 0/0/0 0/0/0 0/0/0 0/0/0 0/0/0 0/0/1 0/0/0 0/0/0 0/0/0 0/0/0 0/0/0 0/0/0 0/0/0 0/0/0 0/0/0 0/0/0 0/0/0 0/0/0 0/0/1 0/0/0 0/0/0 0/0/0 0/0/0 0/0/0 0/0/0 0/0/0 0/0/0 0/0/0 0/0/0 0/0/0 0/0/4 0/0/4 0/0/4 0/0/4 0/0/4 0/0/1 0/0/0 0/0/0 0/0/0 0/0/0 0/0/0 0/0/0 0/0/0 0/0/4 0/0/4 0/0/4 0/0/0 0/0/0 0/0/0 3/0/1 0/0/0 0/0/0 0/0/0
0/0/0 0/0/0 0/0/0 3/0/1 3/0/1 3/0/1 3/0/1 3/0/1 3/0/1 3/0/1 3/0/1 3/0/1 3/0/1 3/0/1 3/0/1 3/0/1 3/0/1 3/0/1 3/0/1 3/0/1 3/0/1 3/0/1 3/0/1 3/0/1 3/0/1 3/0/1 3/0/1 3/0/1 3/0/1 3/0/1 3/0/1 3/0/1 3/0/1 3/0/1 3/0/1 3/0/1 3/0/1 3/0/2 3/0/2 3/0/2 3/0/2 3/0/2 3/0/2 3/0/2 3/0/1 3/0/1 3/0/1 3/0/1 3/0/1 3/0/1 3/0/1 3/0/1 3/0/1 3/0/1 3/0/1 3/0/1 3/0/1 3/0/1 3/0/1 3/0/1 3/0/1 3/0/1 3/0/1 3/0/1 3/0/1 3/0/1 3/0/1 3/0/1 3/0/1 3/0/1 3/0/1 3/0/1 3/0/1 3/0/1 3/0/1 3/0/1 3/0/1 0/0/0 0/0/0 0/0/0
0/3/39/76 10/19/28/61 32/33/32/32/32/34/32/35/39/34/32/36/32/37/32/39/32/38/32/40/32/41/32/42 32/34/32/43