0/0/0 0/0/0 0/0/0 0/0/0 0/0/0 0/0/0 0/0/0 0/0/0 0/0/0 0/0/0 0/0/0 0/0/0 0/0/0 0/0/0 0/0/0 0/0/0 0/0/0 0/0/0 0/0/0 0/0/0 0/0/0 0/0/0 0/0/0 0/0/0 0/0/0 0/0/0 0/0/0 0/0/0 0/0/0 0/0/0 0/0/0 0/0/0 0/0/0 0/0/0 0/0/0 0/0/0 0/0/0 0/0/0 0/0/0 0/0/0
0/0/0 0/0/0 0/0/0 0/0/0 0/0/0 0/0/0 0/0/0 0/0/0 0/0/0 0/0/0 0/0/0 0/0/0 0/0/0 0/0/0 0/0/0 0/0/0 0/0/0 0/0/0 0/0/0 0/0/0 0/0/0 0/0/0 0/0/0 0/0/0 0/0/0 0/0/0 0/0/0 0/0/0 0/0/0 0/0/0 0/0/0 0/0/0 0/0/0 0/0/0 0/0/0 0/0/0 0/0/0 0/0/0 0/0/0 0/0/0
0/0/0 0/0/0 0/0/0 0/0/0 0/0/0 0/0/0 0/0/0 0/0/0 0/0/0 0/0/0 0/0/0 0/0/0 0/0/0 0/0/0 0/0/0 0/0/0 0/0/0 0/0/0 0/0/0 0/0/0 0/0/0 0/0/0 0/0/0 0/0/0 0/0/0 0/0/0 0/0/0 0/0/0 0/0/0 0/0/0 0/0/0 0/0/0 0/0/0 0/0/0 0/0/0 0/0/0 0/0/0 0/0/0 0/0/0 0/0/0
0/0/0 1/0/1 1/0/1 1/0/1 1/0/1 1/0/1 1/0/1 1/0/1 1/0/1 1/0/1 1/0/1 1/0/1 1/0/1 1/0/1 1/0/1 1/0/1 1/0/1 1/0/1 1/0/1 1/0/1 1/0/1 1/0/1 1/0/1 1/0/1 1/0/1 1/0/1 1/0/1 1/0/1 1/0/1 1/0/1 1/0/1 1/0/1 1/0/1 1/0/1 1/0/1 1/0/1 1/0/1 1/0/1 1/0/1 0/0/0
0/0/0 1/0/1 0/0/0 0/0/0 0/0/0 0/0/0 0/0/0 0/0/0 0/0/0 0/0/0 0/0/0 0/0/0 0/0/0 0/0/0 0/0/0 0/0/0 0/0/0 0/0/0 0/0/0 0/0/0 0/0/0 0/0/0 0/0/0 0/0/0 0/0/0 0/0/0 0/0/1 0/0/0 0/0/0 0/0/0 0/0/0 0/0/3 0/0/0 0/0/0 0/0/0 0/0/0 0/0/0 0/0/0 1/0/1 0/0/0
0/0/0 1/0/1 0/0/0 0/0/0 0/0/0 0/0/0 0/0/0 0/0/0 0/0/0 0/0/0 0/0/0 0/0/0 0/0/0 0/0/0 0/0/0 0/0/0 0/0/0 0/0/0 0/0/0 0/0/0 0/0/0 0/0/0 0/0/0 0/0/0 0/0/0 0/0/0 0/0/1 0/0/0 0/0/0 0/0/0 0/0/3 0/0/0 0/0/3 0/0/3 0/0/3 0/0/3 0/0/0 0/0/0 1/0/1 0/0/0
0/0/0 1/0/1 0/0/0 0/0/0 0/0/0 0/0/0 0/0/0 0/0/0 0/0/0 0/0/0 0/0/0 0/0/0 0/0/0 0/0/0 0/0/0 0/0/0 0/0/0 0/0/0 0/0/0 0/0/0 0/0/0 0/0/0 0/0/0 0/0/0 0/0/0 0/0/0 0/0/1 0/0/0 0/0/0 0/0/0 0/0/0 0/0/3 0/0/3 0/0/0 0/0/3 0/0/0 0/0/3 0/0/0 1/0/1 0/0/0
0/0/0 1/0/1 0/0/0 0/0/0 0/0/0 0/0/0 0/0/0 0/0/0 0/0/0 0/0/0 0/0/0 0/0/0 0/0/0 0/0/0 0/0/0 0/0/0 0/0/0 0/0/0 0/0/0 0/0/0 0/0/0 0/0/0 0/0/0 0/0/0 0/0/0 0/0/0 0/0/1 0/0/0 0/0/0 0/0/0 0/0/0 0/0/0 0/0/0 0/0/0 0/0/3 0/0/0 0/0/0 0/0/0 1/0/1 0/0/0
0/0/0 1/0/1 0/0/0 0/0/0 0/0/0 0/0/0 0/0/0 0/0/0 0/0/0 0/0/0 0/0/0 0/0/0 0/0/0 0/0/0 0/0/0 0/0/0 0/0/0 0/0/0 0/0/0 0/0/0 0/0/0 0/0/0 0/0/0 0/0/0 0/0/0 0/0/0 0/0/1 0/0/0 0/0/0 0/0/0 0/0/0 0/0/0 0/0/0 0/0/0 0/0/3 0/0/3 0/0/0 0/0/0 1/0/1 0/0/0
0/0/0 1/0/1 0/0/0 0/0/0 0/0/0 0/0/0 0/0/0 0/0/0 0/0/3 0/0/0 0/0/3 0/0/0 0/0/3 0/0/0 0/0/0 0/0/0 0/0/0 0/0/0 0/0/0 0/0/3 0/0/3 0/0/0 0/0/3 0/0/0 0/0/0 0/0/0 0/0/1 0/0/0 0/0/0 0/0/0 0/0/0 0/0/0 0/0/0 0/0/0 0/0/0 0/0/0 0/0/0 0/0/0 1/0/1 0/0/0
0/0/0 1/0/1 0/0/0 0/0/0 0/0/0 0/0/0 0/0/0 0/0/0 0/0/0 0/0/0 0/0/0 0/0/0 0/0/0 0/0/0 0/0/0 0/0/0 0/0/0 0/0/0 0/0/0 0/0/0 0/0/0 0/0/0 0/0/0 0/0/0 0/0/0 0/0/0 0/0/1 0/0/1 0/0/1 0/0/1 0/0/1 0/0/1 0/0/1 0/0/0 0/0/3 0/0/0 0/0/3 0/0/0 1/0/1 0/0/0
0/0/0 1/0/1 0/0/0 0/0/0 0/0/0 0/0/0 0/0/0 0/0/0 0/0/3 0/0/0 0/0/3 0/0/0 0/0/3 0/0/0 0/0/0 0/0/0 0/0/0 0/0/0 0/0/0 0/0/3 0/0/3 0/0/3 0/0/0 0/0/0 0/0/0 0/0/0 0/0/0 0/0/0 0/0/0 0/0/0 0/0/0 0/0/0 0/0/1 0/0/0 0/0/0 0/0/0 0/0/0 0/0/0 1/0/1 0/0/0
0/0/0 1/0/1 0/0/0 0/0/0 0/0/0 0/0/0 0/0/0 0/0/0 0/0/0 0/0/0 0/0/0 0/0/0 0/0/0 0/0/0 0/0/0 0/0/0 0/0/0 0/0/0 0/0/0 0/0/0 0/0/0 0/0/0 0/0/0 0/0/0 0/0/0 0/0/0 0/0/0 0/0/0 0/0/0 0/0/0 0/0/0 0/0/0 0/0/1 0/0/0 0/0/3 0/0/0 0/0/3 0/0/0 1/0/1 0/0/0
0/0/0 1/0/1 0/0/0 0/0/0 0/0/0 0/0/0 0/0/0 0/0/0 0/0/3 0/0/0 0/0/3 0/0/3 0/0/0 0/0/0 0/0/0 0/0/0 0/0/0 0/0/0 0/0/0 0/0/0 0/0/0 0/0/0 0/0/0 0/0/0 0/0/0 0/0/0 0/0/0 0/0/0 0/0/0 0/0/0 0/0/0 0/0/0 0/0/1 0/0/0 0/0/0 0/0/3 0/0/0 0/0/0 1/0/1 0/0/0
0/0/0 1/0/1 0/0/0 0/0/0 0/0/0 0/0/0 0/0/0 0/0/0 0/0/0 0/0/0 0/0/0 0/0/0 0/0/0 0/0/0 0/0/0 0/0/0 0/0/0 0/0/0 0/0/0 0/0/0 0/0/3 0/0/0 0/0/3 0/0/0 0/0/3 0/0/0 0/0/0 0/0/0 0/0/0 0/0/0 0/0/0 0/0/0 0/0/1 0/0/0 0/0/0 0/0/0 0/0/0 0/0/0 1/0/1 0/0/0
0/0/0 1/0/1 0/0/0 0/0/0 0/0/0 0/0/0 0/0/0 0/0/0 0/0/3 0/0/0 0/0/0 0/0/3 0/0/3 0/0/0 0/0/0 0/0/0 0/0/0 0/0/0 0/0/0 0/0/0 0/0/0 0/0/0 0/0/0 0/0/0 0/0/0 0/0/0 0/0/0 0/0/0 0/0/0 0/0/0 0/0/0 0/0/0 0/0/1 0/0/0 0/0/0 0/0/3 0/0/0 0/0/0 1/0/1 0/0/0
0/0/0 1/0/1 0/0/0 0/0/0 0/0/0 0/0/0 0/0/0 0/0/0 0/0/0 0/0/0 0/0/0 0/0/0 0/0/0 0/0/0 0/0/0 0/0/0 0/0/0 0/0/0 0/0/0 0/0/0 0/0/3 0/0/3 0/0/0 0/0/3 0/0/0 0/0/0 0/0/0 0/0/0 0/0/0 0/0/0 0/0/0 0/0/0 0/0/1 0/0/0 0/0/0 0/0/0 0/0/0 0/0/0 1/0/1 0/0/0
0/0/0 1/0/1 0/0/0 0/0/0 0/0/0 0/0/0 0/0/0 0/0/0 0/0/3 0/0/0 0/0/0 0/0/3 0/0/0 0/0/3 0/0/0 0/0/0 0/0/0 0/0/0 0/0/0 0/0/0 0/0/0 0/0/0 0/0/0 0/0/0 0/0/0 0/0/0 0/0/0 0/0/0 0/0/0 0/0/3 0/0/0 0/0/0 0/0/1 0/0/0 0/0/0 0/0/3 0/0/0 0/0/0 1/0/1 0/0/0
0/0/0 1/0/1 0/0/0 0/0/0 0/0/0 0/0/0 0/0/0 0/0/0 0/0/0 0/0/0 0/0/0 0/0/0 0/0/0 0/0/0 0/0/0 0/0/0 0/0/0 0/0/0 0/0/0 0/0/0 0/0/3 0/0/0 0/0/3 0/0/0 0/0/0 0/0/0 0/0/0 0/0/0 0/0/0 0/0/0 0/0/0 0/0/0 0/0/1 0/0/0 0/0/0 0/0/0 0/0/0 0/0/0 1/0/1 0/0/0
0/0/0 1/0/1 0/0/0 0/0/0 0/0/0 0/0/0 0/0/0 0/0/0 0/0/3 0/0/0 0/0/0 0/0/3 0/0/0 0/0/3 0/0/0 0/0/0 0/0/0 0/0/0 0/0/0 0/0/0 0/0/0 0/0/0 0/0/0 0/0/0 0/0/0 0/0/0 0/0/0 0/0/0 0/0/0 0/0/0 0/0/0 0/0/0 0/0/1 0/0/0 0/0/0 0/0/0 0/0/0 0/0/0 1/0/1 0/0/0
0/0/0 1/0/1 0/0/0 0/0/0 0/0/0 0/0/0 0/0/0 0/0/0 0/0/0 0/0/0 0/0/0 0/0/0 0/0/0 0/0/0 0/0/0 0/0/0 0/0/0 0/0/0 0/0/0 0/0/0 0/0/0 0/0/0 0/0/0 0/0/0 0/0/0 0/0/0 0/0/0 0/0/0 0/0/0 0/0/0 0/0/0 0/0/0 0/0/1 0/0/1 0/0/0 0/0/0 0/0/1 0/0/1 1/0/1 0/0/0
0/0/0 1/0/1 0/0/0 0/0/0 0/0/0 0/0/0 0/0/0 0/0/0 0/0/0 0/0/0 0/0/0 0/0/0 0/0/0 0/0/0 0/0/0 0/0/0 0/0/0 0/0/0 0/0/0 0/0/0 0/0/0 0/0/0 0/0/0 0/0/0 0/0/0 0/0/0 0/0/0 0/0/0 0/0/0 0/0/0 0/0/0 0/0/0 0/0/0 0/0/0 0/0/0 0/0/0 0/0/0 0/0/0 1/0/1 0/0/0
0/0/0 1/0/1 0/0/0 0/0/0 0/0/0 0/0/0 0/0/0 0/0/0 0/0/3 0/0/0 0/0/0 0/0/3 0/0/0 0/0/3 0/0/0 0/0/0 0/0/0 0/0/0 0/0/0 0/0/3 0/0/0 0/0/0 0/0/0 0/0/3 0/0/3 0/0/3 0/0/0 0/0/0 0/0/3 0/0/0 0/0/0 0/0/0 0/0/0 0/0/0 0/0/0 0/0/0 0/0/0 0/0/0 1/0/1 0/0/0
0/0/0 1/0/1 0/0/0 0/0/0 0/0/0 0/0/0 0/0/0 0/0/0 0/0/0 0/0/0 0/0/0 0/0/0 0/0/0 0/0/0 0/0/0 0/0/0 0/0/0 0/0/0 0/0/0 0/0/0 0/0/0 0/0/0 0/0/0 0/0/0 0/0/0 0/0/0 0/0/0 0/0/0 0/0/0 0/0/0 0/0/0 0/0/0 0/0/0 0/0/0 0/0/0 0/0/0 0/0/0 0/0/0 1/0/1 0/0/0
0/0/0 1/0/1 0/0/0 0/0/0 0/0/0 0/0/0 0/0/0 0/0/0 0/0/3 0/0/0 0/0/0 0/0/3 0/0/0 0/0/0 0/0/0 0/0/0 0/0/0 0/0/0 0/0/0 0/0/3 0/0/0 0/0/0 0/0/3 0/0/3 0/0/3 0/0/3 0/0/0 0/0/0 0/0/3 0/0/0 0/0/0 0/0/0 0/0/0 0/0/0 0/0/0 0/0/0 0/0/0 0/0/0 1/0/1 0/0/0
0/0/0 1/0/1 0/0/0 0/0/0 0/0/0 0/0/0 0/0/0 0/0/0 0/0/0 0/0/0 0/0/0 0/0/0 0/0/0 0/0/3 0/0/0 0/0/0 0/0/0 0/0/0 0/0/0 0/0/0 0/0/0 0/0/0 0/0/0 0/0/0 0/0/0 0/0/0 0/0/0 0/0/0 0/0/0 0/0/0 0/0/0 0/0/0 0/0/0 0/0/0 0/0/0 0/0/0 0/0/0 0/0/0 1/0/1 0/0/0
0/0/0 1/0/1 0/0/0 0/0/0 0/0/0 0/0/0 0/0/0 0/0/0 0/0/0 0/0/0 0/0/0 0/0/0 0/0/0 0/0/0 0/0/0 0/0/0 0/0/0 0/0/0 0/0/0 0/0/0 0/0/0 0/0/0 0/0/0 0/0/0 0/0/0 0/0/0 0/0/0 0/0/0 0/0/0 0/0/0 0/0/0 0/0/0 0/0/0 0/0/0 0/0/0 0/0/0 0/0/0 0/0/0 1/0/1 0/0/0
0/0/0 1/0/1 0/0/0 0/0/0 0/0/0 0/0/0 0/0/0 0/0/3 0/0/0 0/0/0 0/0/3 0/0/3 0/0/0 0/0/0 0/0/0 0/0/0 0/0/0 0/0/0 0/0/0 0/0/0 0/0/0 0/0/0 0/0/0 0/0/0 0/0/0 0/0/0 0/0/0 0/0/0 0/0/0 0/0/0 0/0/0 0/0/0 0/0/0 0/0/0 0/0/0 0/0/0 0/0/0 0/0/0 1/0/1 0/0/0
0/0/0 1/0/1 0/0/0 0/0/0 0/0/0 0/0/0 0/0/0 0/0/0 0/0/0 0/0/0 0/0/0 0/0/0 0/0/0 0/0/0 0/0/0 0/0/0 0/0/0 0/0/0 0/0/1 0/0/1 0/0/1 0/0/1 0/0/1 0/0/1 0/0/1 0/0/1 0/0/1 0/0/1 0/0/1 0/0/1 0/0/1 0/0/1 0/0/0 0/0/0 0/0/0 0/0/0 0/0/0 0/0/0 1/0/1 0/0/0
0/0/0 1/0/1 0/0/0 0/0/0 0/0/0 0/0/0 0/0/0 0/0/3 0/0/0 0/0/3 0/0/0 0/0/0 0/0/3 0/0/0 0/0/0 0/0/0 0/0/0 0/0/0 0/0/1 0/0/0 0/0/0 0/0/0 0/0/0 0/0/0 0/0/0 0/0/0 0/0/0 0/0/0 0/0/0 0/0/0 0/0/0 0/0/1 0/0/0 0/0/0 0/0/0 0/0/0 0/0/0 0/0/0 1/0/1 0/0/0
0/0/0 1/0/1 0/0/0 0/0/0 0/0/0 0/0/0 0/0/0 0/0/0 0/0/0 0/0/0 0/0/0 0/0/0 0/0/0 0/0/0 0/0/0 0/0/0 0/0/0 0/0/0 0/0/1 0/0/0 0/0/0 0/0/0 0/0/0 0/0/0 0/0/0 0/0/0 0/0/0 0/0/0 0/0/0 0/0/0 0/0/0 0/0/1 0/0/0 0/0/0 0/0/0 0/0/0 0/0/0 0/0/0 1/0/1 0/0/0
0/0/0 1/0/1 0/0/0 0/0/0 0/0/0 0/0/0 0/0/0 0/0/3 0/0/0 0/0/0 0/0/0 0/0/0 0/0/0 0/0/0 0/0/0 0/0/0 0/0/0 0/0/0 0/0/1 0/0/0 0/0/0 0/0/0 0/0/0 0/0/0 0/0/0 0/0/0 0/0/0 0/0/0 0/0/0 0/0/0 0/0/0 0/0/1 0/0/0 0/0/0 0/0/0 0/0/0 0/0/0 0/0/0 1/0/1 0/0/0
0/0/0 1/0/1 0/0/0 0/0/0 0/0/0 0/0/0 0/0/0 0/0/0 0/0/0 0/0/0 0/0/0 0/0/3 0/0/0 0/0/0 0/0/0 0/0/0 0/0/0 0/0/0 0/0/1 0/0/0 0/0/0 0/0/0 0/0/0 0/0/0 0/0/0 0/0/0 0/0/0 0/0/0 0/0/0 0/0/0 0/0/0 0/0/0 0/0/0 0/0/0 0/0/0 0/0/0 0/0/0 0/0/0 1/0/1 0/0/0
0/0/0 1/0/1 0/0/0 0/0/0 0/0/0 0/0/0 0/0/0 0/0/0 0/0/0 0/0/0 0/0/0 0/0/0 0/0/0 0/0/0 0/0/0 0/0/0 0/0/0 0/0/0 0/0/1 0/0/0 0/0/0 0/0/0 0/0/0 0/0/0 0/0/0 0/0/0 0/0/0 0/0/0 0/0/0 0/0/0 0/0/0 0/0/0 0/0/0 0/0/0 0/0/0 0/0/0 0/0/0 0/0/0 1/0/1 0/0/0
0/0/0 1/0/1 0/0/1 0/0/1 0/0/1 0/0/1 0/0/1 0/0/1 0/0/1 0/0/0 0/0/0 0/0/1 0/0/1 0/0/1 0/0/0 0/0/0 0/0/0 0/0/0 0/0/1 0/0/0 0/0/0 0/0/0 0/0/0 0/0/0 0/0/0 0/0/0 0/0/0 0/0/0 0/0/0 0/0/0 0/0/0 0/0/1 0/0/0 0/0/0 0/0/0 0/0/0 0/0/0 0/0/0 1/0/1 0/0/0
0/0/0 1/0/1 0/0/0 0/0/0 0/0/0 0/0/0 0/0/0 0/0/0 0/0/0 0/0/0 0/0/0 0/0/0 0/0/0 0/0/1 0/0/0 0/0/0 0/0/0 0/0/0 0/0/1 0/0/0 0/0/0 0/0/0 0/0/0 0/0/0 0/0/0 0/0/0 0/0/0 0/0/0 0/0/0 0/0/0 0/0/0 0/0/1 0/0/0 0/0/0 0/0/0 0/0/0 0/0/0 0/0/0 1/0/1 0/0/0
0/0/0 1/0/1 0/0/0 0/0/3 0/0/0 0/0/3 0/0/0 0/0/0 0/0/0 0/0/0 0/0/3 0/0/0 0/0/0 0/0/1 0/0/0 0/0/0 0/0/0 0/0/0 0/0/1 0/0/0 0/0/0 0/0/0 0/0/0 0/0/0 0/0/0 0/0/0 0/0/0 0/0/0 0/0/0 0/0/0 0/0/0 0/0/1 0/0/0 0/0/0 0/0/0 0/0/0 0/0/0 0/0/0 1/0/1 0/0/0
0/0/0 1/0/1 0/0/0 0/0/0 0/0/0 0/0/0 0/0/0 0/0/0 0/0/3 0/0/0 0/0/0 0/0/0 0/0/0 0/0/1 0/0/0 0/0/0 0/0/0 0/0/0 0/0/1 0/0/0 0/0/0 0/0/0 0/0/0 0/0/0 0/0/0 0/0/0 0/0/0 0/0/0 0/0/0 0/0/0 0/0/0 0/0/1 0/0/0 0/0/0 0/0/0 0/0/0 0/0/0 0/0/0 1/0/1 0/0/0
0/0/0 1/0/1 0/0/0 0/0/3 0/0/0 0/0/0 0/0/0 0/0/0 0/0/0 0/0/0 0/0/0 0/0/0 0/0/0 0/0/1 0/0/0 0/0/0 0/0/0 0/0/0 0/0/1 0/0/0 0/0/0 0/0/0 0/0/0 0/0/0 0/0/0 0/0/0 0/0/0 0/0/0 0/0/0 0/0/0 0/0/0 0/0/1 0/0/0 0/0/0 0/0/0 0/0/0 0/0/0 0/0/0 1/0/1 0/0/0
0/0/0 1/0/1 0/0/0 0/0/0 0/0/0 0/0/0 0/0/3 0/0/0 0/0/3 0/0/0 0/0/0 0/0/3 0/0/0 0/0/1 0/0/0 0/0/0 0/0/0 0/0/0 0/0/1 0/0/0 0/0/0 0/0/0 0/0/0 0/0/0 0/0/0 0/0/0 0/0/0 0/0/0 0/0/0 0/0/0 0/0/0 0/0/1 0/0/0 0/0/0 0/0/0 0/0/0 0/0/0 0/0/0 1/0/1 0/0/0
0/0/0 1/0/1 0/0/0 0/0/3 0/0/0 0/0/0 0/0/0 0/0/0 0/0/3 0/0/0 0/0/0 0/0/0 0/0/0 0/0/1 0/0/0 0/0/0 0/0/0 0/0/0 0/0/1 0/0/0 0/0/0 0/0/0 0/0/0 0/0/0 0/0/0 0/0/0 0/0/0 0/0/0 0/0/0 0/0/0 0/0/0 0/0/1 0/0/0 0/0/0 0/0/0 0/0/0 0/0/0 0/0/0 1/0/1 0/0/0
0/0/0 1/0/1 0/0/0 0/0/0 0/0/0 0/0/0 0/0/0 0/0/0 0/0/0 0/0/0 0/0/0 0/0/0 0/0/0 0/0/1 0/0/0 0/0/0 0/0/0 0/0/0 0/0/0 0/0/0 0/0/0 0/0/0 0/0/0 0/0/0 0/0/0 0/0/0 0/0/0 0/0/0 0/0/0 0/0/0 0/0/0 0/0/1 0/0/0 0/0/0 0/0/0 0/0/0 0/0/0 0/0/0 1/0/1 0/0/0
0/0/0 1/0/1 0/0/0 0/0/0 0/0/0 0/0/0 0/0/0 0/0/0 0/0/0 0/0/0 0/0/0 0/0/0 0/0/0 0/0/1 0/0/0 0/0/0 0/0/0 0/0/0 0/0/0 0/0/0 0/0/0 0/0/0 0/0/0 0/0/0 0/0/0 0/0/0 0/0/0 0/0/0 0/0/0 0/0/0 0/0/0 0/0/1 0/0/0 0/0/0 0/0/0 0/0/0 0/0/0 0/0/0 1/0/1 0/0/0
0/0/0 1/0/1 0/0/1 0/0/1 0/0/1 0/0/1 0/0/1 0/0/1 0/0/1 0/0/0 0/0/0 0/0/1 0/0/1 0/0/1 0/0/1 0/0/0 0/0/0 0/0/1 0/0/1 0/0/1 0/0/1 0/0/1 0/0/1 0/0/1 0/0/1 0/0/1 0/0/1 0/0/1 0/0/1 0/0/1 0/0/1 0/0/1 0/0/1 0/0/1 0/0/1 0/0/1 0/0/1 0/0/1 1/0/1 0/0/0
0/0/0 1/0/1 0/0/0 0/0/0 0/0/0 0/0/0 0/0/0 0/0/0 0/0/0 0/0/0 0/0/0 0/0/0 0/0/0 0/0/0 0/0/0 0/0/0 0/0/0 0/0/0 0/0/0 0/0/0 0/0/0 0/0/0 0/0/0 0/0/0 0/0/0 0/0/0 0/0/0 0/0/0 0/0/0 0/0/0 0/0/0 0/0/0 0/0/0 0/0/0 0/0/0 0/0/0 0/0/0 0/0/0 1/0/1 0/0/0
0/0/0 1/0/1 0/0/0 0/0/0 0/0/0 0/0/0 0/0/0 0/0/0 0/0/0 0/0/0 0/0/0 0/0/0 0/0/0 0/0/0 0/0/0 0/0/0 0/0/0 0/0/0 0/0/0 0/0/0 0/0/0 0/0/0 0/0/0 0/0/0 0/0/0 0/0/0 0/0/0 0/0/0 0/0/0 0/0/0 0/0/0 0/0/0 0/0/0 0/0/0 0/0/0 0/0/0 0/0/0 0/0/0 1/0/1 0/0/0
0/0/0 1/0/2 0/0/0 0/0/0 0/0/0 0/0/0 0/0/0 0/0/0 0/0/0 0/0/0 0/0/0 0/0/0 0/0/0 0/0/0 0/0/0 0/0/0 0/0/0 0/0/0 0/0/0 0/0/0 0/0/0 0/0/0 0/0/0 0/0/0 0/0/0 0/0/0 0/0/0 0/0/0 0/0/0 0/0/0 0/0/0 0/0/0 0/0/0 0/0/0 0/0/0 0/0/0 0/0/0 0/0/0 1/0/1 0/0/0
0/0/0 1/0/2 0/0/0 0/0/0 0/0/0 0/0/0 0/0/0 0/0/0 0/0/0 0/0/0 0/0/0 0/0/0 0/0/0 0/0/0 0/0/0 0/0/0 0/0/0 0/0/0 0/0/0 0/0/0 0/0/0 0/0/0 0/0/0 0/0/0 0/0/0 0/0/0 0/0/0 0/0/0 0/0/0 0/0/0 0/0/0 0/0/0 0/0/0 0/0/0 0/0/0 0/0/0 0/0/0 0/0/0 1/0/1 0/0/0
0/0/0 1/0/2 0/0/0 0/0/0 0/0/0 0/0/0 0/0/0 0/0/0 0/0/0 0/0/0 0/0/0 0/0/0 0/0/0 0/0/0 0/0/0 0/0/0 0/0/0 0/0/0 0/0/0 0/0/0 0/0/0 0/0/0 0/0/0 0/0/0 0/0/0 0/0/0 0/0/0 0/0/0 0/0/0 0/0/0 0/0/0 0/0/0 0/0/0 0/0/0 0/0/0 0/0/0 0/0/0 0/0/0 1/0/1 0/0/0
0/0/0 1/0/2 0/0/0 0/0/0 0/0/0 0/0/0 0/0/0 0/0/0 0/0/0 0/0/0 0/0/0 0/0/0 0/0/0 0/0/0 0/0/0 0/0/0 0/0/0 0/0/0 0/0/0 0/0/0 0/0/0 0/0/0 0/0/0 0/0/0 0/0/0 0/0/0 0/0/0 0/0/0 0/0/0 0/0/0 0/0/0 0/0/0 0/0/0 0/0/0 0/0/0 0/0/0 0/0/0 0/0/0 1/0/1 0/0/0
0/0/0 1/0/1 0/0/0 0/0/0 0/0/0 0/0/0 0/0/0 0/0/0 0/0/0 0/0/0 0/0/0 0/0/0 0/0/0 0/0/0 0/0/0 0/0/0 0/0/0 0/0/0 0/0/0 0/0/0 0/0/0 0/0/0 0/0/0 0/0/0 0/0/0 0/0/0 0/0/0 0/0/0 0/0/0 0/0/0 0/0/0 0/0/0 0/0/0 0/0/0 0/0/0 0/0/0 0/0/0 0/0/0 1/0/1 0/0/0
0/0/0 1/0/1 0/0/0 0/0/0 0/0/0 0/0/0 0/0/0 0/0/0 0/0/0 0/0/0 0/0/0 0/0/0 0/0/0 0/0/0 0/0/0 0/0/0 0/0/0 0/0/0 0/0/0 0/0/0 0/0/0 0/0/0 0/0/0 0/0/0 0/0/0 0/0/0 0/0/0 0/0/0 0/0/0 0/0/0 0/0/0 0/0/0 0/0/0 0/0/0 0/0/0 0/0/0 0/0/0 0/0/0 1/0/1 0/0/0
0/0/0 1/0/1 0/0/1 0/0/1 0/0/1 0/0/1 0/0/1 0/0/1 0/0/1 0/0/1 0/0/1 0/0/1 0/0/1 0/0/0 0/0/0 0/0/1 0/0/1 0/0/1 0/0/0 0/0/0 0/0/0 0/0/1 0/0/1 0/0/1 0/0/1 0/0/1 0/0/1 0/0/1 0/0/1 0/0/1 0/0/1 0/0/1 0/0/1 0/0/1 0/0/1 0/0/1 0/0/1 0/0/1 1/0/1 0/0/0
0/0/0 1/0/1 0/0/0 0/0/0 0/0/0 0/0/0 0/0/0 0/0/0 0/0/0 0/0/0 0/0/0 0/0/0 0/0/0 0/0/0 0/0/0 0/0/0 0/0/1 0/0/0 0/0/0 0/0/0 0/0/0 0/0/0 0/0/0 0/0/0 0/0/4 0/0/4 0/0/0 0/0/0 0/0/0 0/0/0 0/0/4 0/0/4 0/0/0 0/0/0 0/0/0 0/0/0 0/0/0 0/0/0 1/0/1 0/0/0
0/0/0 1/0/1 0/0/0 0/0/0 0/0/0 0/0/0 0/0/0 0/0/0 0/0/0 0/0/0 0/0/0 0/0/0 0/0/0 0/0/0 0/0/0 0/0/0 0/0/1 0/0/0 0/0/0 0/0/0 0/0/0 0/0/0 0/0/0 0/0/0 0/0/4 0/0/4 0/0/0 0/0/0 0/0/0 0/0/0 0/0/4 0/0/4 0/0/0 0/0/0 0/0/0 0/0/4 0/0/4 0/0/4 1/0/1 0/0/0
0/0/0 1/0/1 0/0/0 0/0/0 0/0/0 0/0/0 0/0/0 0/0/4 0/0/4 0/0/4 0/0/4 0/0/4 0/0/0 0/0/0 0/0/0 0/0/0 0/0/1 0/0/0 0/0/0 0/0/0 0/0/0 0/0/0 0/0/0 0/0/0 0/0/4 0/0/4 0/0/0 0/0/0 0/0/0 0/0/0 0/0/4 0/0/4 0/0/0 0/0/0 0/0/0 0/0/4 0/0/4 0/0/4 1/0/1 0/0/0
0/0/0 1/0/1 0/0/0 0/0/0 0/0/0 0/0/0 0/0/0 0/0/4 0/0/4 0/0/4 0/0/4 0/0/4 0/0/0 0/0/0 0/0/0 0/0/0 0/0/1 0/0/0 0/0/0 0/0/0 0/0/0 0/0/0 0/0/0 0/0/0 0/0/0 0/0/0 0/0/0 0/0/0 0/0/0 0/0/0 0/0/0 0/0/0 0/0/0 0/0/0 0/0/0 0/0/0 0/0/0 0/0/0 1/0/1 0/0/0
0/0/0 1/0/1 0/0/0 0/0/0 0/0/0 0/0/0 0/0/0 0/0/4 0/0/4 0/0/4 0/0/4 0/0/4 0/0/0 0/0/0 0/0/0 0/0/0 0/0/1 0/0/0 0/0/0 0/0/0 0/0/0 0/0/0 0/0/0 0/0/3 0/0/3 0/0/3 0/0/3 0/0/3 0/0/0 0/0/0 0/0/3 0/0/0 0/0/0 0/0/0 0/0/0 0/0/0 0/0/0 0/0/0 1/0/1 0/0/0
0/0/0 1/0/1 0/0/0 0/0/0 0/0/0 0/0/0 0/0/0 0/0/0 0/0/0 0/0/0 0/0/0 0/0/0 0/0/0 0/0/0 0/0/0 0/0/0 0/0/1 0/0/0 0/0/0 0/0/0 0/0/0 0/0/0 0/0/3 0/0/0 0/0/0 0/0/0 0/0/0 0/0/0 0/0/0 0/0/0 0/0/0 0/0/3 0/0/0 0/0/0 0/0/0 0/0/0 0/0/0 0/0/0 1/0/1 0/0/0
0/0/0 1/0/1 0/0/0 0/0/0 0/0/0 0/0/0 0/0/0 0/0/0 0/0/0 0/0/0 0/0/0 0/0/0 0/0/0 0/0/0 0/0/0 0/0/0 0/0/1 0/0/0 0/0/0 0/0/0 0/0/0 0/0/0 0/0/3 0/0/0 0/0/0 0/0/0 0/0/0 0/0/0 0/0/0 0/0/0 0/0/0 0/0/3 0/0/0 0/0/0 0/0/0 0/0/4 0/0/4 0/0/4 1/0/1 0/0/0
0/0/0 1/0/1 0/0/0 0/0/0 0/0/0 0/0/0 0/0/0 0/0/0 0/0/0 0/0/0 0/0/0 0/0/0 0/0/0 0/0/0 0/0/0 0/0/0 0/0/1 0/0/0 0/0/0 0/0/0 0/0/0 0/0/0 0/0/3 0/0/0 0/0/0 0/0/0 0/0/0 0/0/0 0/0/0 0/0/0 0/0/0 0/0/0 0/0/0 0/0/0 0/0/0 0/0/4 0/0/4 0/0/4 1/0/1 0/0/0
0/0/0 1/0/1 0/0/0 0/0/0 0/0/0 0/0/4 0/0/4 0/0/4 0/0/4 0/0/4 0/0/4 0/0/4 0/0/0 0/0/0 0/0/0 0/0/0 0/0/1 0/0/0 0/0/0 0/0/0 0/0/0 0/0/0 0/0/0 0/0/0 0/0/0 0/0/0 0/0/0 0/0/0 0/0/0 0/0/0 0/0/0 0/0/3 0/0/0 0/0/0 0/0/0 0/0/0 0/0/0 0/0/0 1/0/1 0/0/0
0/0/0 1/0/1 0/0/0 0/0/0 0/0/0 0/0/4 0/0/4 0/0/4 0/0/4 0/0/4 0/0/4 0/0/4 0/0/0 0/0/0 0/0/0 0/0/0 0/0/1 0/0/0 0/0/0 0/0/0 0/0/0 0/0/0 0/0/3 0/0/0 0/0/0 0/0/0 0/0/0 0/0/0 0/0/0 0/0/0 0/0/0 0/0/0 0/0/0 0/0/0 0/0/0 0/0/0 0/0/0 0/0/0 1/0/1 0/0/0
0/0/0 1/0/1 0/0/0 0/0/0 0/0/0 0/0/0 0/0/0 0/0/0 0/0/0 0/0/0 0/0/0 0/0/0 0/0/0 0/0/0 0/0/0 0/0/0 0/0/1 0/0/0 0/0/0 0/0/0 0/0/0 0/0/0 0/0/0 0/0/0 0/0/0 0/0/0 0/0/0 0/0/0 0/0/0 0/0/0 0/0/0 0/0/3 0/0/0 0/0/0 0/0/0 0/0/0 0/0/0 0/0/0 1/0/1 0/0/0
0/0/0 1/0/1 0/0/0 0/0/0 0/0/0 0/0/0 0/0/0 0/0/0 0/0/0 0/0/0 0/0/0 0/0/0 0/0/0 0/0/0 0/0/0 0/0/0 0/0/1 0/0/0 0/0/0 0/0/0 0/0/0 0/0/0 0/0/3 0/0/0 0/0/0 0/0/0 0/0/0 0/0/0 0/0/0 0/0/0 0/0/0 0/0/0 0/0/0 0/0/0 0/0/0 0/0/4 0/0/4 0/0/4 1/0/1 0/0/0
0/0/0 1/0/1 0/0/0 0/0/0 0/0/0 0/0/0 0/0/0 0/0/0 0/0/0 0/0/0 0/0/0 0/0/0 0/0/0 0/0/0 0/0/0 0/0/0 0/0/1 0/0/0 0/0/0 0/0/0 0/0/0 0/0/0 0/0/0 0/0/0 0/0/0 0/0/0 0/0/0 0/0/0 0/0/0 0/0/0 0/0/0 0/0/3 0/0/0 0/0/0 0/0/0 0/0/4 0/0/4 0/0/4 1/0/1 0/0/0
0/0/0 1/0/1 0/0/0 0/0/0 0/0/0 0/0/0 0/0/0 0/0/0 0/0/0 0/0/0 0/0/0 0/0/0 0/0/0 0/0/0 0/0/0 0/0/0 0/0/1 0/0/0 0/0/0 0/0/0 0/0/0 0/0/0 0/0/3 0/0/0 0/0/3 0/0/3 0/0/3 0/0/3 0/0/0 0/0/0 0/0/0 0/0/0 0/0/0 0/0/0 0/0/0 0/0/0 0/0/0 0/0/0 1/0/1 0/0/0
0/0/0 1/0/1 0/0/0 0/0/0 0/0/0 0/0/0 0/0/0 0/0/0 0/0/0 0/0/0 0/0/0 0/0/0 0/0/0 0/0/0 0/0/0 0/0/0 0/0/1 0/0/0 0/0/0 0/0/0 0/0/0 0/0/0 0/0/0 0/0/0 0/0/0 0/0/0 0/0/0 0/0/0 0/0/0 0/0/3 0/0/0 0/0/3 0/0/0 0/0/0 0/0/0 0/0/0 0/0/0 0/0/0 1/0/1 0/0/0
0/0/0 1/0/1 0/0/0 0/0/0 0/0/0 0/0/0 0/0/0 0/0/0 0/0/0 0/0/0 0/0/0 0/0/0 0/0/0 0/0/0 0/0/0 0/0/0 0/0/1 0/0/0 0/0/0 0/0/0 0/0/0 0/0/0 0/0/0 0/0/0 0/0/0 0/0/0 0/0/0 0/0/0 0/0/0 0/0/0 0/0/0 0/0/0 0/0/0 0/0/0 0/0/0 0/0/0 0/0/0 0/0/0 1/0/1 0/0/0
0/0/0 1/0/1 0/0/0 0/0/0 0/0/0 0/0/0 0/0/0 0/0/0 0/0/0 0/0/0 0/0/0 0/0/0 0/0/0 0/0/0 0/0/0 0/0/0 0/0/1 0/0/0 0/0/0 0/0/0 0/0/4 0/0/4 0/0/0 0/0/0 0/0/0 0/0/4 0/0/4 0/0/0 0/0/0 0/0/0 0/0/4 0/0/4 0/0/0 0/0/0 0/0/0 0/0/0 0/0/0 0/0/0 1/0/1 0/0/0
0/0/0 1/0/1 0/0/0 0/0/0 0/0/0 0/0/0 0/0/0 0/0/0 0/0/0 0/0/0 0/0/0 0/0/0 0/0/0 0/0/0 0/0/0 0/0/0 0/0/1 0/0/0 0/0/0 0/0/0 0/0/4 0/0/4 0/0/0 0/0/0 0/0/0 0/0/4 0/0/4 0/0/0 0/0/0 0/0/0 0/0/4 0/0/4 0/0/0 0/0/0 0/0/0 0/0/0 0/0/0 0/0/0 1/0/1 0/0/0
0/0/0 1/0/1 0/0/0 0/0/0 0/0/0 0/0/0 0/0/0 0/0/0 0/0/0 0/0/0 0/0/0 0/0/0 0/0/0 0/0/0 0/0/0 0/0/0 0/0/1 0/0/0 0/0/0 0/0/0 0/0/4 0/0/4 0/0/0 0/0/0 0/0/0 0/0/4 0/0/4 0/0/0 0/0/0 0/0/0 0/0/4 0/0/4 0/0/0 0/0/0 0/0/0 0/0/0 0/0/0 0/0/0 1/0/1 0/0/0
0/0/0 1/0/1 1/0/1 1/0/1 1/0/1 1/0/1 1/0/1 1/0/1 1/0/1 1/0/1 1/0/1 1/0/1 1/0/1 1/0/1 1/0/1 1/0/1 1/0/1 1/0/1 1/0/1 1/0/1 1/0/1 1/0/1 1/0/1 1/0/1 1/0/1 1/0/1 1/0/1 1/0/1 1/0/1 1/0/1 1/0/1 1/0/1 1/0/1 1/0/1 1/0/1 1/0/1 1/0/1 1/0/1 1/0/1 0/0/0
0/0/0 0/0/0 0/0/0 0/0/0 0/0/0 0/0/0 0/0/0 0/0/0 0/0/0 0/0/0 0/0/0 0/0/0 0/0/0 0/0/0 0/0/0 0/0/0 0/0/0 0/0/0 0/0/0 0/0/0 0/0/0 0/0/0 0/0/0 0/0/0 0/0/0 0/0/0 0/0/0 0/0/0 0/0/0 0/0/0 0/0/0 0/0/0 0/0/0 0/0/0 0/0/0 0/0/0 0/0/0 0/0/0 0/0/0 0/0/0
0/0/0 0/0/0 0/0/0 0/0/0 0/0/0 0/0/0 0/0/0 0/0/0 0/0/0 0/0/0 0/0/0 0/0/0 0/0/0 0/0/0 0/0/0 0/0/0 0/0/0 0/0/0 0/0/0 0/0/0 0/0/0 0/0/0 0/0/0 0/0/0 0/0/0 0/0/0 0/0/0 0/0/0 0/0/0 0/0/0 0/0/0 0/0/0 0/0/0 0/0/0 0/0/0 0/0/0 0/0/0 0/0/0 0/0/0 0/0/0
0/0/0 0/0/0 0/0/0 0/0/0 0/0/0 0/0/0 0/0/0 0/0/0 0/0/0 0/0/0 0/0/0 0/0/0 0/0/0 0/0/0 0/0/0 0/0/0 0/0/0 0/0/0 0/0/0 0/0/0 0/0/0 0/0/0 0/0/0 0/0/0 0/0/0 0/0/0 0/0/0 0/0/0 0/0/0 0/0/0 0/0/0 0/0/0 0/0/0 0/0/0 0/0/0 0/0/0 0/0/0 0/0/0 0/0/0 0/0/0
0/0/0 0/0/0 0/0/0 0/0/0 0/0/0 0/0/0 0/0/0 0/0/0 0/0/0 0/0/0 0/0/0 0/0/0 0/0/0 0/0/0 0/0/0 0/0/0 0/0/0 0/0/0 0/0/0 0/0/0 0/0/0 0/0/0 0/0/0 0/0/0 0/0/0 0/0/0 0/0/0 0/0/0 0/0/0 0/0/0 0/0/0 0/0/0 0/0/0 0/0/0 0/0/0 0/0/0 0/0/0 0/0/0 0/0/0 0/0/0
0/0/0 0/0/0 0/0/0 0/0/0 0/0/0 0/0/0 0/0/0 0/0/0 0/0/0 0/0/0 0/0/0 0/0/0 0/0/0 0/0/0 0/0/0 0/0/0 0/0/0 0/0/0 0/0/0 0/0/0 0/0/0 0/0/0 0/0/0 0/0/0 0/0/0 0/0/0 0/0/0 0/0/0 0/0/0 0/0/0 0/0/0 0/0/0 0/0/0 0/0/0 0/0/0 0/0/0 0/0/0 0/0/0 0/0/0 0/0/0
0/0/0 0/0/0 0/0/0 0/0/0 0/0/0 0/0/0 0/0/0 0/0/0 0/0/0 0/0/0 0/0/0 0/0/0 0/0/0 0/0/0 0/0/0 0/0/0 0/0/0 0/0/0 0/0/0 0/0/0 0/0/0 0/0/0 0/0/0 0/0/0 0/0/0 0/0/0 0/0/0 0/0/0 0/0/0 0/0/0 0/0/0 0/0/0 0/0/0 0/0/0 0/0/0 0/0/0 0/0/0 0/0/0 0/0/0 0/0/0
0/0/0 0/0/0 0/0/0 0/0/0 0/0/0 0/0/0 0/0/0 0/0/0 0/0/0 0/0/0 0/0/0 0/0/0 0/0/0 0/0/0 0/0/0 0/0/0 0/0/0 0/0/0 0/0/0 0/0/0 0/0/0 0/0/0 0/0/0 0/0/0 0/0/0 0/0/0 0/0/0 0/0/0 0/0/0 0/0/0 0/0/0 0/0/0 0/0/0 0/0/0 0/0/0 0/0/0 0/0/0 0/0/0 0/0/0 0/0/0
3_1-72_38/124/78/46_1-47_1-48_1-49_1