0/0/0 1/0/1 1/0/1 1/0/1 1/0/1 1/0/1 1/0/1 1/0/1 1/0/1 1/0/1 1/0/1 1/0/1 1/0/1 1/0/1 1/0/1 1/0/1 1/0/1 1/0/1 1/0/1 1/0/1 1/0/1 1/0/1 1/0/1 1/0/1 1/0/1 1/0/1 1/0/1 1/0/1 1/0/1 1/0/1 1/0/1 1/0/1 1/0/1 1/0/1 1/0/2 1/0/2 1/0/2 1/0/2 1/0/1 1/0/1 1/0/1 1/0/1 1/0/1 1/0/1 1/0/1 1/0/1 1/0/1 1/0/1 1/0/1 1/0/1 1/0/1 1/0/1 1/0/1 1/0/1 1/0/1 1/0/1 1/0/1 1/0/1 1/0/1 1/0/1 1/0/1 1/0/1 1/0/1 1/0/1 1/0/1 1/0/1 1/0/1 1/0/1 1/0/1 1/0/1 1/0/1 1/0/1 1/0/1 1/0/1 1/0/1 1/0/1 1/0/1 0/0/0 0/0/0 0/0/0
0/0/0 1/0/1 0/0/0 0/0/0 0/0/0 0/0/0 0/0/0 0/0/0 0/0/0 0/0/1 0/0/0 0/0/0 0/0/0 0/0/0 0/0/0 0/0/0 0/0/0 0/0/0 0/0/0 0/0/0 0/0/0 0/0/0 0/0/0 0/0/0 0/0/0 0/0/0 0/0/0 0/0/0 0/0/0 0/0/0 0/0/0 0/0/0 0/0/0 0/0/0 0/0/0 0/0/0 0/0/0 0/0/0 0/0/0 0/0/0 0/0/0 0/0/0 0/0/0 0/0/0 0/0/0 0/0/0 0/0/0 0/0/0 0/0/0 0/0/0 0/0/0 0/0/0 0/0/0 0/0/0 0/0/0 0/0/0 0/0/0 0/0/0 0/0/0 0/0/0 0/0/0 0/0/0 0/0/0 0/0/0 0/0/0 0/0/0 0/0/0 0/0/0 0/0/0 0/0/0 0/0/0 0/0/0 0/0/0 0/0/0 0/0/0 0/0/0 1/0/1 0/0/0 0/0/0 0/0/0
0/0/0 1/0/1 0/0/4 0/0/4 0/0/4 0/0/0 0/0/0 0/0/0 0/0/0 0/0/1 0/0/0 0/0/0 0/0/0 0/0/0 0/0/0 0/0/0 0/0/0 0/0/0 0/0/0 0/0/0 0/0/0 0/0/0 0/0/0 0/0/0 0/0/0 0/0/0 0/0/0 0/0/0 0/0/0 0/0/0 0/0/0 0/0/0 0/0/0 0/0/0 0/0/0 0/0/0 0/0/0 0/0/0 0/0/0 0/0/0 0/0/0 0/0/0 0/0/0 0/0/0 0/0/0 0/0/0 0/0/0 0/0/0 0/0/0 0/0/0 0/0/0 0/0/0 0/0/0 0/0/0 0/0/0 0/0/0 0/0/0 0/0/0 0/0/0 0/0/0 0/0/0 0/0/0 0/0/0 0/0/0 0/0/0 0/0/0 0/0/0 0/0/0 0/0/0 0/0/0 0/0/0 0/0/0 0/0/0 0/0/0 0/0/0 0/0/0 1/0/1 0/0/0 0/0/0 0/0/0
0/0/0 1/0/1 0/0/4 0/0/4 0/0/4 0/0/0 0/0/0 0/0/0 0/0/0 0/0/1 0/0/0 0/0/0 0/0/0 0/0/0 0/0/0 0/0/0 0/0/0 0/0/0 0/0/0 0/0/0 0/0/0 0/0/0 0/0/0 0/0/0 0/0/0 0/0/0 0/0/0 0/0/0 0/0/0 0/0/0 0/0/0 0/0/0 0/0/0 0/0/0 0/0/0 0/0/0 0/0/0 0/0/0 0/0/0 0/0/0 0/0/0 0/0/0 0/0/0 0/0/0 0/0/0 0/0/0 0/0/0 0/0/0 0/0/0 0/0/0 0/0/0 0/0/0 0/0/0 0/0/0 0/0/0 0/0/0 0/0/0 0/0/0 0/0/0 0/0/0 0/0/0 0/0/0 0/0/0 0/0/0 0/0/0 0/0/0 0/0/0 0/0/0 0/0/0 0/0/0 0/0/0 0/0/0 0/0/0 0/0/0 0/0/0 0/0/0 1/0/1 0/0/0 0/0/0 0/0/0
0/0/0 1/0/1 0/0/0 0/0/0 0/0/0 0/0/0 0/0/0 0/0/0 0/0/0 0/0/1 0/0/0 0/0/0 0/0/0 0/0/0 0/0/0 0/0/0 0/0/0 0/0/0 0/0/0 0/0/0 0/0/0 0/0/0 0/0/0 0/0/0 0/0/0 0/0/0 0/0/0 0/0/0 0/0/0 0/0/0 0/0/0 0/0/0 0/0/0 0/0/0 0/0/0 0/0/0 0/0/0 0/0/0 0/0/0 0/0/0 0/0/0 0/0/0 0/0/0 0/0/0 0/0/0 0/0/0 0/0/0 0/0/0 0/0/0 0/0/0 0/0/0 0/0/0 0/0/0 0/0/0 0/0/0 0/0/0 0/0/0 0/0/0 0/0/0 0/0/0 0/0/1 0/0/0 0/0/0 0/0/0 0/0/0 0/0/0 0/0/0 0/0/0 0/0/0 0/0/0 0/0/0 0/0/0 0/0/0 0/0/0 0/0/0 0/0/0 1/0/1 0/0/0 0/0/0 0/0/0
0/0/0 1/0/1 0/0/4 0/0/4 0/0/4 0/0/0 0/0/0 0/0/0 0/0/0 0/0/1 0/0/0 0/0/0 0/0/0 0/0/0 0/0/0 0/0/0 0/0/0 0/0/0 0/0/0 0/0/0 0/0/0 0/0/0 0/0/0 0/0/0 0/0/0 0/0/0 0/0/0 0/0/0 0/0/0 0/0/0 0/0/0 0/0/0 0/0/0 0/0/0 0/0/0 0/0/0 0/0/0 0/0/0 0/0/0 0/0/0 0/0/0 0/0/0 0/0/0 0/0/0 0/0/0 0/0/0 0/0/0 0/0/0 0/0/0 0/0/0 0/0/0 0/0/0 0/0/0 0/0/0 0/0/0 0/0/0 0/0/0 0/0/0 0/0/0 0/0/0 0/0/1 0/0/0 0/0/0 0/0/0 0/0/0 0/0/0 0/0/0 0/0/0 0/0/0 0/0/0 0/0/0 0/0/0 0/0/0 0/0/0 0/0/0 0/0/0 1/0/1 0/0/0 0/0/0 0/0/0
0/0/0 1/0/1 0/0/4 0/0/4 0/0/4 0/0/0 0/0/0 0/0/0 0/0/0 0/0/1 0/0/0 0/0/0 0/0/0 0/0/0 0/0/0 0/0/0 0/0/1 0/0/1 0/0/0 0/0/0 0/0/0 0/0/0 0/0/0 0/0/0 0/0/0 0/0/0 0/0/0 0/0/0 0/0/0 0/0/0 0/0/0 0/0/0 0/0/0 0/0/0 0/0/0 0/0/0 0/0/0 0/0/0 0/0/0 0/0/0 0/0/0 0/0/0 0/0/0 0/0/0 0/0/0 0/0/0 0/0/0 0/0/0 0/0/0 0/0/0 0/0/0 0/0/0 0/0/0 0/0/0 0/0/0 0/0/0 0/0/0 0/0/0 0/0/0 0/0/0 0/0/1 0/0/0 0/0/0 0/0/0 0/0/0 0/0/0 0/0/0 0/0/0 0/0/0 0/0/0 0/0/0 0/0/0 0/0/0 0/0/0 0/0/0 0/0/0 1/0/1 0/0/0 0/0/0 0/0/0
0/0/0 1/0/1 0/0/0 0/0/0 0/0/0 0/0/0 0/0/0 0/0/0 0/0/0 0/0/1 0/0/0 0/0/0 0/0/0 0/0/0 0/0/0 0/0/0 0/0/0 0/0/1 0/0/1 0/0/1 0/0/1 0/0/1 0/0/1 0/0/1 0/0/1 0/0/1 0/0/1 0/0/1 0/0/1 0/0/1 0/0/1 0/0/1 0/0/1 0/0/1 0/0/1 0/0/1 0/0/1 0/0/1 0/0/1 0/0/1 0/0/1 0/0/1 0/0/1 0/0/1 0/0/1 0/0/1 0/0/1 0/0/1 0/0/1 0/0/1 0/0/1 0/0/1 0/0/0 0/0/0 0/0/0 0/0/0 0/0/0 0/0/0 0/0/0 0/0/0 0/0/1 0/0/0 0/0/0 0/0/0 0/0/0 0/0/0 0/0/0 0/0/0 0/0/0 0/0/0 0/0/0 0/0/0 0/0/0 0/0/0 0/0/0 0/0/0 1/0/1 0/0/0 0/0/0 0/0/0
0/0/0 1/0/1 0/0/0 0/0/0 0/0/0 0/0/0 0/0/0 0/0/0 0/0/0 0/0/1 0/0/0 0/0/0 0/0/0 0/0/0 0/0/0 0/0/0 0/0/0 0/0/0 0/0/0 0/0/0 0/0/0 0/0/0 0/0/3 0/0/3 0/0/3 0/0/3 0/0/3 0/0/3 0/0/3 0/0/3 0/0/3 0/0/3 0/0/3 0/0/3 0/0/3 0/0/3 0/0/3 0/0/3 0/0/3 0/0/3 0/0/3 0/0/3 0/0/3 0/0/3 0/0/3 0/0/3 0/0/3 0/0/3 0/0/3 0/0/3 0/0/3 0/0/1 0/0/0 0/0/0 0/0/0 0/0/0 0/0/0 0/0/0 0/0/0 0/0/0 0/0/1 0/0/0 0/0/0 0/0/0 0/0/0 0/0/0 0/0/0 0/0/0 0/0/0 0/0/0 0/0/0 0/0/0 0/0/0 0/0/0 0/0/0 0/0/0 1/0/1 0/0/0 0/0/0 0/0/0
0/0/0 1/0/1 0/0/0 0/0/0 0/0/0 0/0/0 0/0/0 0/0/0 0/0/0 0/0/0 0/0/0 0/0/0 0/0/0 0/0/0 0/0/0 0/0/0 0/0/0 0/0/0 0/0/0 0/0/0 0/0/0 0/0/0 0/0/0 0/0/0 0/0/0 0/0/0 0/0/0 0/0/0 0/0/0 0/0/0 0/0/0 0/0/0 0/0/0 0/0/0 0/0/0 0/0/0 0/0/0 0/0/0 0/0/0 0/0/0 0/0/0 0/0/0 0/0/0 0/0/0 0/0/0 0/0/3 0/0/3 0/0/3 0/0/3 0/0/3 0/0/3 0/0/1 0/0/0 0/0/0 0/0/0 0/0/0 0/0/0 0/0/0 0/0/0 0/0/0 0/0/1 0/0/0 0/0/0 0/0/0 0/0/0 0/0/0 0/0/0 0/0/0 0/0/0 0/0/0 0/0/0 0/0/0 0/0/0 0/0/0 0/0/0 0/0/0 1/0/1 0/0/0 0/0/0 0/0/0
0/0/0 1/0/1 0/0/0 0/0/0 0/0/0 0/0/0 0/0/0 0/0/0 0/0/0 0/0/0 0/0/0 0/0/0 0/0/0 0/0/0 0/0/0 0/0/0 0/0/1 0/0/0 0/0/0 0/0/0 0/0/0 0/0/0 0/0/0 0/0/0 0/0/0 0/0/0 0/0/0 0/0/0 0/0/0 0/0/0 0/0/0 0/0/0 0/0/0 0/0/0 0/0/0 0/0/0 0/0/0 0/0/0 0/0/0 0/0/0 0/0/0 0/0/0 0/0/0 0/0/0 0/0/0 0/0/0 0/0/0 0/0/3 0/0/3 0/0/3 0/0/3 0/0/1 0/0/0 0/0/0 0/0/0 0/0/0 0/0/0 0/0/0 0/0/0 0/0/0 0/0/1 0/0/0 0/0/0 0/0/0 0/0/0 0/0/0 0/0/0 0/0/0 0/0/0 0/0/0 0/0/0 0/0/0 0/0/0 0/0/0 0/0/0 0/0/0 1/0/1 0/0/0 0/0/0 0/0/0
0/0/0 1/0/1 0/0/0 0/0/0 0/0/0 0/0/0 0/0/0 0/0/0 0/0/0 0/0/0 0/0/0 0/0/0 0/0/0 0/0/0 0/0/0 0/0/0 0/0/1 0/0/0 0/0/0 0/0/0 0/0/0 0/0/0 0/0/0 0/0/0 0/0/0 0/0/0 0/0/3 0/0/0 0/0/0 0/0/3 0/0/0 0/0/0 0/0/0 0/0/3 0/0/0 0/0/0 0/0/0 0/0/3 0/0/0 0/0/0 0/0/0 0/0/0 0/0/0 0/0/0 0/0/0 0/0/0 0/0/0 0/0/0 0/0/3 0/0/3 0/0/3 0/0/1 0/0/0 0/0/0 0/0/0 0/0/0 0/0/0 0/0/0 0/0/0 0/0/0 0/0/1 0/0/0 0/0/0 0/0/0 0/0/0 0/0/0 0/0/0 0/0/0 0/0/0 0/0/0 0/0/0 0/0/0 0/0/0 0/0/0 0/0/0 0/0/0 1/0/1 0/0/0 0/0/0 0/0/0
0/0/0 1/0/1 0/0/1 0/0/1 0/0/1 0/0/1 0/0/1 0/0/1 0/0/1 0/0/1 0/0/1 0/0/1 0/0/1 0/0/0 0/0/0 0/0/0 0/0/1 0/0/0 0/0/0 0/0/0 0/0/0 0/0/0 0/0/0 0/0/0 0/0/0 0/0/0 0/0/3 0/0/0 0/0/0 0/0/3 0/0/0 0/0/0 0/0/0 0/0/3 0/0/0 0/0/0 0/0/0 0/0/3 0/0/0 0/0/0 0/0/0 0/0/0 0/0/0 0/0/0 0/0/0 0/0/0 0/0/0 0/0/0 0/0/0 0/0/3 0/0/3 0/0/1 0/0/0 0/0/0 0/0/0 0/0/0 0/0/0 0/0/0 0/0/0 0/0/0 0/0/1 0/0/0 0/0/0 0/0/0 0/0/1 0/0/1 0/0/1 0/0/1 0/0/1 0/0/1 0/0/1 0/0/1 0/0/1 0/0/1 0/0/1 0/0/1 1/0/1 0/0/0 0/0/0 0/0/0
0/0/0 1/0/1 0/0/0 0/0/0 0/0/0 0/0/0 0/0/0 0/0/0 0/0/0 0/0/0 0/0/0 0/0/0 0/0/1 0/0/0 0/0/0 0/0/0 0/0/1 0/0/1 0/0/1 0/0/0 0/0/0 0/0/0 0/0/0 0/0/0 0/0/0 0/0/0 0/0/3 0/0/0 0/0/0 0/0/3 0/0/0 0/0/0 0/0/0 0/0/3 0/0/0 0/0/0 0/0/0 0/0/3 0/0/0 0/0/0 0/0/0 0/0/0 0/0/0 0/0/0 0/0/0 0/0/0 0/0/0 0/0/0 0/0/0 0/0/0 0/0/3 0/0/1 0/0/0 0/0/0 0/0/0 0/0/0 0/0/0 0/0/0 0/0/0 0/0/0 0/0/0 0/0/0 0/0/0 0/0/0 0/0/0 0/0/0 0/0/0 0/0/0 0/0/0 0/0/0 0/0/0 0/0/0 0/0/0 0/0/0 0/0/0 0/0/0 1/0/1 0/0/0 0/0/0 0/0/0
0/0/0 1/0/1 0/0/0 0/0/0 0/0/0 0/0/0 0/0/0 0/0/0 0/0/0 0/0/0 0/0/0 0/0/0 0/0/1 0/0/0 0/0/0 0/0/0 0/0/0 0/0/0 0/0/1 0/0/0 0/0/0 0/0/0 0/0/0 0/0/0 0/0/0 0/0/0 0/0/3 0/0/0 0/0/0 0/0/3 0/0/0 0/0/0 0/0/0 0/0/3 0/0/0 0/0/0 0/0/0 0/0/3 0/0/0 0/0/0 0/0/0 0/0/0 0/0/0 0/0/0 0/0/0 0/0/0 0/0/0 0/0/0 0/0/0 0/0/0 0/0/0 0/0/1 0/0/0 0/0/0 0/0/0 0/0/0 0/0/0 0/0/0 0/0/0 0/0/0 0/0/0 0/0/0 0/0/0 0/0/0 0/0/0 0/0/0 0/0/0 0/0/0 0/0/0 0/0/0 0/0/0 0/0/0 0/0/0 0/0/0 0/0/0 0/0/0 1/0/2 0/0/0 0/0/0 0/0/0
0/0/0 1/0/1 0/0/0 0/0/0 0/0/0 0/0/0 0/0/0 0/0/0 0/0/0 0/0/0 0/0/0 0/0/0 0/0/1 0/0/0 0/0/0 0/0/0 0/0/0 0/0/0 0/0/1 0/0/3 0/0/0 0/0/0 0/0/0 0/0/0 0/0/0 0/0/0 0/0/3 0/0/0 0/0/0 0/0/3 0/0/0 0/0/0 0/0/0 0/0/3 0/0/0 0/0/0 0/0/0 0/0/3 0/0/0 0/0/0 0/0/0 0/0/0 0/0/0 0/0/0 0/0/0 0/0/0 0/0/0 0/0/0 0/0/0 0/0/0 0/0/0 0/0/1 0/0/0 0/0/0 0/0/0 0/0/0 0/0/0 0/0/0 0/0/0 0/0/0 0/0/0 0/0/0 0/0/0 0/0/0 0/0/0 0/0/0 0/0/0 0/0/0 0/0/0 0/0/0 0/0/0 0/0/0 0/0/0 0/0/0 0/0/0 0/0/0 1/0/2 0/0/0 0/0/0 0/0/0
0/0/0 1/0/1 0/0/0 0/0/0 0/0/0 0/0/0 0/0/0 0/0/0 0/0/0 0/0/0 0/0/0 0/0/0 0/0/1 0/0/0 0/0/0 0/0/0 0/0/0 0/0/0 0/0/1 0/0/3 0/0/3 0/0/0 0/0/0 0/0/0 0/0/0 0/0/0 0/0/0 0/0/0 0/0/0 0/0/0 0/0/0 0/0/0 0/0/0 0/0/0 0/0/0 0/0/0 0/0/0 0/0/3 0/0/0 0/0/0 0/0/0 0/0/0 0/0/0 0/0/0 0/0/0 0/0/0 0/0/0 0/0/0 0/0/0 0/0/0 0/0/0 0/0/1 0/0/0 0/0/0 0/0/0 0/0/0 0/0/0 0/0/0 0/0/0 0/0/0 0/0/0 0/0/0 0/0/0 0/0/0 0/0/0 0/0/0 0/0/0 0/0/0 0/0/0 0/0/0 0/0/0 0/0/0 0/0/0 0/0/0 0/0/0 0/0/0 1/0/2 0/0/0 0/0/0 0/0/0
0/0/0 1/0/1 0/0/0 0/0/0 0/0/0 0/0/0 0/0/0 0/0/0 0/0/0 0/0/0 0/0/0 0/0/0 0/0/1 0/0/0 0/0/0 0/0/0 0/0/0 0/0/0 0/0/1 0/0/3 0/0/3 0/0/3 0/0/0 0/0/0 0/0/0 0/0/0 0/0/0 0/0/0 0/0/0 0/0/0 0/0/0 0/0/0 0/0/0 0/0/0 0/0/0 0/0/0 0/0/0 0/0/0 0/0/0 0/0/0 0/0/0 0/0/0 0/0/0 0/0/0 0/0/0 0/0/0 0/0/0 0/0/0 0/0/0 0/0/0 0/0/0 0/0/0 0/0/0 0/0/0 0/0/0 0/0/0 0/0/0 0/0/0 0/0/0 0/0/0 0/0/0 0/0/0 0/0/0 0/0/0 0/0/0 0/0/0 0/0/0 0/0/0 0/0/0 0/0/0 0/0/0 0/0/0 0/0/0 0/0/0 0/0/0 0/0/0 1/0/2 0/0/0 0/0/0 0/0/0
0/0/0 1/0/1 0/0/0 0/0/0 0/0/0 0/0/0 0/0/0 0/0/0 0/0/0 0/0/0 0/0/0 0/0/0 0/0/1 0/0/0 0/0/0 0/0/0 0/0/0 0/0/0 0/0/1 0/0/3 0/0/3 0/0/3 0/0/3 0/0/3 0/0/3 0/0/3 0/0/3 0/0/3 0/0/3 0/0/3 0/0/3 0/0/3 0/0/3 0/0/3 0/0/3 0/0/3 0/0/3 0/0/0 0/0/0 0/0/0 0/0/0 0/0/0 0/0/0 0/0/0 0/0/0 0/0/0 0/0/0 0/0/0 0/0/0 0/0/0 0/0/0 0/0/0 0/0/0 0/0/0 0/0/0 0/0/0 0/0/0 0/0/0 0/0/0 0/0/0 0/0/0 0/0/0 0/0/0 0/0/0 0/0/0 0/0/0 0/0/0 0/0/0 0/0/0 0/0/0 0/0/0 0/0/0 0/0/0 0/0/0 0/0/0 0/0/0 1/0/1 0/0/0 0/0/0 0/0/0
0/0/0 1/0/1 0/0/3 0/0/0 0/0/0 0/0/0 0/0/0 0/0/0 0/0/0 0/0/0 0/0/0 0/0/0 0/0/1 0/0/0 0/0/0 0/0/0 0/0/0 0/0/0 0/0/1 0/0/1 0/0/1 0/0/1 0/0/1 0/0/1 0/0/1 0/0/1 0/0/1 0/0/1 0/0/1 0/0/1 0/0/1 0/0/1 0/0/1 0/0/1 0/0/1 0/0/1 0/0/1 0/0/1 0/0/1 0/0/1 0/0/1 0/0/1 0/0/1 0/0/1 0/0/1 0/0/1 0/0/1 0/0/1 0/0/1 0/0/1 0/0/1 0/0/1 0/0/0 0/0/0 0/0/0 0/0/0 0/0/0 0/0/0 0/0/0 0/0/0 0/0/0 0/0/0 0/0/0 0/0/0 0/0/0 0/0/1 0/0/1 0/0/1 0/0/1 0/0/1 0/0/1 0/0/1 0/0/1 0/0/1 0/0/1 0/0/1 1/0/1 0/0/0 0/0/0 0/0/0
0/0/0 1/0/1 0/0/3 0/0/0 0/0/0 0/0/0 0/0/0 0/0/0 0/0/0 0/0/0 0/0/0 0/0/0 0/0/1 0/0/0 0/0/0 0/0/0 0/0/0 0/0/0 0/0/0 0/0/0 0/0/0 0/0/0 0/0/0 0/0/0 0/0/0 0/0/0 0/0/0 0/0/0 0/0/0 0/0/0 0/0/0 0/0/0 0/0/0 0/0/0 0/0/0 0/0/0 0/0/0 0/0/0 0/0/0 0/0/0 0/0/0 0/0/0 0/0/0 0/0/0 0/0/0 0/0/0 0/0/0 0/0/0 0/0/0 0/0/0 0/0/0 0/0/0 0/0/0 0/0/0 0/0/0 0/0/0 0/0/0 0/0/0 0/0/0 0/0/0 0/0/0 0/0/0 0/0/0 0/0/0 0/0/0 0/0/0 0/0/0 0/0/0 0/0/0 0/0/0 0/0/0 0/0/0 0/0/0 0/0/0 0/0/0 0/0/0 1/0/1 0/0/0 0/0/0 0/0/0
0/0/0 1/0/1 0/0/3 0/0/0 0/0/0 0/0/0 0/0/0 0/0/0 0/0/0 0/0/0 0/0/0 0/0/0 0/0/1 0/0/0 0/0/0 0/0/0 0/0/0 0/0/0 0/0/0 0/0/0 0/0/0 0/0/0 0/0/0 0/0/0 0/0/0 0/0/0 0/0/0 0/0/0 0/0/0 0/0/0 0/0/0 0/0/0 0/0/0 0/0/0 0/0/0 0/0/0 0/0/0 0/0/0 0/0/0 0/0/0 0/0/0 0/0/0 0/0/0 0/0/0 0/0/0 0/0/0 0/0/0 0/0/0 0/0/0 0/0/0 0/0/0 0/0/0 0/0/0 0/0/0 0/0/0 0/0/0 0/0/0 0/0/0 0/0/0 0/0/0 0/0/0 0/0/0 0/0/0 0/0/0 0/0/0 0/0/0 0/0/0 0/0/0 0/0/0 0/0/0 0/0/0 0/0/0 0/0/0 0/0/0 0/0/0 0/0/0 1/0/1 0/0/0 0/0/0 0/0/0
0/0/0 1/0/1 0/0/3 0/0/0 0/0/0 0/0/0 0/0/0 0/0/0 0/0/0 0/0/0 0/0/0 0/0/0 0/0/1 0/0/0 0/0/0 0/0/0 0/0/0 0/0/0 0/0/0 0/0/0 0/0/0 0/0/0 0/0/0 0/0/0 0/0/0 0/0/0 0/0/0 0/0/0 0/0/0 0/0/0 0/0/0 0/0/0 0/0/0 0/0/0 0/0/0 0/0/0 0/0/0 0/0/0 0/0/0 0/0/0 0/0/0 0/0/0 0/0/0 0/0/0 0/0/0 0/0/0 0/0/0 0/0/0 0/0/0 0/0/0 0/0/0 0/0/0 0/0/0 0/0/0 0/0/0 0/0/0 0/0/0 0/0/0 0/0/0 0/0/0 0/0/0 0/0/0 0/0/0 0/0/0 0/0/0 0/0/0 0/0/0 0/0/0 0/0/0 0/0/0 0/0/0 0/0/0 0/0/0 0/0/0 0/0/0 0/0/0 1/0/1 0/0/0 0/0/0 0/0/0
0/0/0 1/0/1 0/0/3 0/0/0 0/0/0 0/0/0 0/0/0 0/0/0 0/0/0 0/0/0 0/0/0 0/0/0 0/0/0 0/0/0 0/0/0 0/0/0 0/0/0 0/0/0 0/0/0 0/0/0 0/0/0 0/0/0 0/0/0 0/0/0 0/0/0 0/0/0 0/0/0 0/0/0 0/0/0 0/0/0 0/0/0 0/0/0 0/0/0 0/0/0 0/0/0 0/0/0 0/0/0 0/0/0 0/0/0 0/0/0 0/0/0 0/0/0 0/0/0 0/0/0 0/0/0 0/0/0 0/0/0 0/0/0 0/0/0 0/0/0 0/0/0 0/0/0 0/0/0 0/0/0 0/0/0 0/0/0 0/0/0 0/0/0 0/0/0 0/0/0 0/0/0 0/0/0 0/0/0 0/0/0 0/0/0 0/0/1 0/0/1 0/0/0 0/0/0 0/0/0 0/0/0 0/0/0 0/0/0 0/0/0 0/0/0 0/0/0 1/0/1 0/0/0 0/0/0 0/0/0
0/0/0 1/0/1 0/0/3 0/0/0 0/0/0 0/0/0 0/0/0 0/0/0 0/0/0 0/0/0 0/0/0 0/0/0 0/0/0 0/0/0 0/0/0 0/0/0 0/0/0 0/0/0 0/0/0 0/0/0 0/0/0 0/0/0 0/0/0 0/0/0 0/0/0 0/0/0 0/0/0 0/0/0 0/0/0 0/0/0 0/0/0 0/0/0 0/0/0 0/0/0 0/0/0 0/0/0 0/0/0 0/0/0 0/0/0 0/0/0 0/0/0 0/0/0 0/0/0 0/0/0 0/0/0 0/0/0 0/0/0 0/0/0 0/0/0 0/0/0 0/0/0 0/0/0 0/0/0 0/0/0 0/0/0 0/0/0 0/0/0 0/0/0 0/0/0 0/0/0 0/0/0 0/0/0 0/0/0 0/0/0 0/0/0 0/0/0 0/0/1 0/0/0 0/0/0 0/0/0 0/0/0 0/0/0 0/0/0 0/0/0 0/0/0 0/0/0 1/0/1 0/0/0 0/0/0 0/0/0
0/0/0 1/0/1 0/0/3 0/0/0 0/0/0 0/0/0 0/0/0 0/0/0 0/0/0 0/0/0 0/0/0 0/0/0 0/0/1 0/0/1 0/0/1 0/0/1 0/0/1 0/0/1 0/0/1 0/0/1 0/0/1 0/0/0 0/0/0 0/0/1 0/0/0 0/0/0 0/0/1 0/0/1 0/0/1 0/0/1 0/0/1 0/0/1 0/0/1 0/0/1 0/0/1 0/0/1 0/0/1 0/0/1 0/0/1 0/0/1 0/0/1 0/0/1 0/0/0 0/0/0 0/0/1 0/0/0 0/0/0 0/0/1 0/0/1 0/0/1 0/0/1 0/0/1 0/0/1 0/0/1 0/0/1 0/0/1 0/0/0 0/0/0 0/0/1 0/0/1 0/0/1 0/0/1 0/0/1 0/0/1 0/0/1 0/0/0 0/0/1 0/0/0 0/0/0 0/0/0 0/0/0 0/0/0 0/0/0 0/0/0 0/0/0 0/0/0 1/0/1 0/0/0 0/0/0 0/0/0
0/0/0 1/0/1 0/0/3 0/0/0 0/0/0 0/0/0 0/0/0 0/0/0 0/0/0 0/0/0 0/0/0 0/0/0 0/0/1 0/0/0 0/0/0 0/0/0 0/0/0 0/0/0 0/0/0 0/0/0 0/0/0 0/0/0 0/0/0 0/0/1 0/0/0 0/0/0 0/0/0 0/0/0 0/0/0 0/0/0 0/0/0 0/0/0 0/0/0 0/0/0 0/0/1 0/0/0 0/0/0 0/0/0 0/0/0 0/0/0 0/0/0 0/0/0 0/0/0 0/0/0 0/0/1 0/0/0 0/0/0 0/0/0 0/0/0 0/0/0 0/0/0 0/0/0 0/0/0 0/0/0 0/0/0 0/0/1 0/0/0 0/0/0 0/0/0 0/0/0 0/0/0 0/0/0 0/0/0 0/0/0 0/0/1 0/0/1 0/0/1 0/0/0 0/0/0 0/0/0 0/0/0 0/0/0 0/0/0 0/0/0 0/0/0 0/0/0 1/0/1 0/0/0 0/0/0 0/0/0
0/0/0 1/0/1 0/0/3 0/0/0 0/0/0 0/0/0 0/0/0 0/0/0 0/0/0 0/0/0 0/0/0 0/0/0 0/0/1 0/0/0 0/0/0 0/0/0 0/0/0 0/0/0 0/0/0 0/0/0 0/0/0 0/0/0 0/0/0 0/0/1 0/0/0 0/0/0 0/0/0 0/0/0 0/0/0 0/0/0 0/0/0 0/0/0 0/0/0 0/0/0 0/0/1 0/0/0 0/0/0 0/0/0 0/0/0 0/0/0 0/0/0 0/0/0 0/0/0 0/0/0 0/0/1 0/0/0 0/0/0 0/0/0 0/0/0 0/0/0 0/0/0 0/0/0 0/0/0 0/0/0 0/0/0 0/0/1 0/0/0 0/0/0 0/0/0 0/0/0 0/0/0 0/0/0 0/0/0 0/0/0 0/0/0 0/0/0 0/0/1 0/0/0 0/0/0 0/0/0 0/0/0 0/0/0 0/0/0 0/0/0 0/0/0 0/0/0 1/0/1 0/0/0 0/0/0 0/0/0
0/0/0 1/0/1 0/0/3 0/0/0 0/0/0 0/0/0 0/0/0 0/0/0 0/0/0 0/0/0 0/0/0 0/0/0 0/0/1 0/0/4 0/0/4 0/0/4 0/0/0 0/0/0 0/0/0 0/0/0 0/0/0 0/0/0 0/0/0 0/0/1 0/0/4 0/0/4 0/0/4 0/0/0 0/0/0 0/0/0 0/0/0 0/0/0 0/0/0 0/0/0 0/0/1 0/0/4 0/0/4 0/0/4 0/0/0 0/0/0 0/0/0 0/0/0 0/0/0 0/0/0 0/0/1 0/0/0 0/0/0 0/0/0 0/0/0 0/0/0 0/0/0 0/0/0 0/0/4 0/0/4 0/0/4 0/0/1 0/0/0 0/0/0 0/0/0 0/0/0 0/0/0 0/0/0 0/0/0 0/0/4 0/0/4 0/0/4 0/0/1 0/0/1 0/0/1 0/0/0 0/0/0 0/0/1 0/0/0 0/0/1 0/0/1 0/0/1 1/0/1 0/0/0 0/0/0 0/0/0
0/0/0 1/0/1 0/0/3 0/0/0 0/0/0 0/0/0 0/0/0 0/0/0 0/0/0 0/0/0 0/0/0 0/0/0 0/0/1 0/0/4 0/0/4 0/0/4 0/0/0 0/0/0 0/0/0 0/0/0 0/0/0 0/0/0 0/0/0 0/0/1 0/0/4 0/0/4 0/0/4 0/0/0 0/0/0 0/0/0 0/0/0 0/0/0 0/0/0 0/0/0 0/0/1 0/0/4 0/0/4 0/0/4 0/0/0 0/0/0 0/0/0 0/0/0 0/0/0 0/0/0 0/0/1 0/0/0 0/0/0 0/0/0 0/0/0 0/0/0 0/0/0 0/0/0 0/0/4 0/0/4 0/0/4 0/0/1 0/0/0 0/0/0 0/0/0 0/0/0 0/0/0 0/0/0 0/0/0 0/0/4 0/0/4 0/0/4 0/0/1 0/0/4 0/0/0 0/0/0 0/0/0 0/0/1 0/0/0 0/0/0 0/0/0 0/0/0 1/0/1 0/0/0 0/0/0 0/0/0
0/0/0 1/0/1 0/0/3 0/0/0 0/0/0 0/0/0 0/0/0 0/0/0 0/0/0 0/0/0 0/0/0 0/0/0 0/0/1 0/0/0 0/0/0 0/0/0 0/0/0 0/0/0 0/0/0 0/0/0 0/0/0 0/0/0 0/0/0 0/0/1 0/0/0 0/0/0 0/0/0 0/0/0 0/0/0 0/0/0 0/0/0 0/0/0 0/0/0 0/0/0 0/0/1 0/0/0 0/0/0 0/0/0 0/0/0 0/0/0 0/0/0 0/0/0 0/0/0 0/0/0 0/0/1 0/0/0 0/0/0 0/0/0 0/0/0 0/0/0 0/0/0 0/0/0 0/0/0 0/0/0 0/0/0 0/0/1 0/0/0 0/0/0 0/0/0 0/0/0 0/0/0 0/0/0 0/0/0 0/0/0 0/0/0 0/0/0 0/0/1 0/0/4 0/0/0 0/0/0 0/0/0 0/0/1 0/0/0 0/0/0 0/0/0 0/0/0 1/0/1 0/0/0 0/0/0 0/0/0
0/0/0 1/0/1 0/0/3 0/0/0 0/0/0 0/0/0 0/0/0 0/0/0 0/0/0 0/0/0 0/0/0 0/0/0 0/0/1 0/0/0 0/0/0 0/0/0 0/0/0 0/0/0 0/0/0 0/0/0 0/0/0 0/0/0 0/0/0 0/0/1 0/0/0 0/0/0 0/0/0 0/0/0 0/0/0 0/0/0 0/0/0 0/0/0 0/0/0 0/0/0 0/0/1 0/0/0 0/0/0 0/0/0 0/0/0 0/0/0 0/0/0 0/0/0 0/0/0 0/0/0 0/0/1 0/0/0 0/0/0 0/0/0 0/0/0 0/0/0 0/0/0 0/0/0 0/0/0 0/0/0 0/0/0 0/0/1 0/0/0 0/0/0 0/0/0 0/0/0 0/0/0 0/0/0 0/0/0 0/0/4 0/0/4 0/0/4 0/0/1 0/0/4 0/0/0 0/0/0 0/0/0 0/0/1 0/0/0 0/0/4 0/0/4 0/0/4 1/0/1 0/0/0 0/0/0 0/0/0
0/0/0 1/0/1 0/0/3 0/0/0 0/0/0 0/0/0 0/0/0 0/0/0 0/0/0 0/0/0 0/0/0 0/0/0 0/0/1 0/0/4 0/0/4 0/0/4 0/0/0 0/0/0 0/0/0 0/0/0 0/0/0 0/0/0 0/0/0 0/0/1 0/0/4 0/0/4 0/0/4 0/0/0 0/0/0 0/0/0 0/0/0 0/0/0 0/0/0 0/0/0 0/0/1 0/0/4 0/0/4 0/0/4 0/0/0 0/0/0 0/0/0 0/0/0 0/0/0 0/0/0 0/0/1 0/0/0 0/0/0 0/0/0 0/0/0 0/0/0 0/0/0 0/0/0 0/0/4 0/0/4 0/0/4 0/0/1 0/0/0 0/0/0 0/0/0 0/0/0 0/0/0 0/0/0 0/0/0 0/0/4 0/0/4 0/0/4 0/0/1 0/0/0 0/0/0 0/0/0 0/0/0 0/0/1 0/0/0 0/0/4 0/0/4 0/0/4 1/0/1 0/0/0 0/0/0 0/0/0
0/0/0 1/0/1 0/0/3 0/0/0 0/0/0 0/0/0 0/0/0 0/0/0 0/0/0 0/0/0 0/0/0 0/0/0 0/0/1 0/0/4 0/0/4 0/0/4 0/0/0 0/0/0 0/0/0 0/0/0 0/0/0 0/0/0 0/0/0 0/0/1 0/0/4 0/0/4 0/0/4 0/0/0 0/0/0 0/0/0 0/0/0 0/0/0 0/0/0 0/0/0 0/0/1 0/0/4 0/0/4 0/0/4 0/0/0 0/0/0 0/0/0 0/0/0 0/0/0 0/0/0 0/0/1 0/0/0 0/0/0 0/0/0 0/0/0 0/0/0 0/0/0 0/0/0 0/0/4 0/0/4 0/0/4 0/0/1 0/0/0 0/0/0 0/0/0 0/0/0 0/0/0 0/0/0 0/0/0 0/0/0 0/0/0 0/0/0 0/0/1 0/0/4 0/0/4 0/0/0 0/0/0 0/0/1 0/0/0 0/0/0 0/0/0 0/0/0 1/0/1 0/0/0 0/0/0 0/0/0
0/0/0 1/0/1 0/0/3 0/0/0 0/0/0 0/0/0 0/0/0 0/0/0 0/0/0 0/0/0 0/0/0 0/0/0 0/0/1 0/0/0 0/0/0 0/0/0 0/0/0 0/0/0 0/0/0 0/0/0 0/0/0 0/0/0 0/0/0 0/0/1 0/0/0 0/0/0 0/0/0 0/0/0 0/0/0 0/0/0 0/0/0 0/0/0 0/0/0 0/0/0 0/0/1 0/0/0 0/0/0 0/0/0 0/0/0 0/0/0 0/0/0 0/0/0 0/0/0 0/0/0 0/0/1 0/0/0 0/0/0 0/0/0 0/0/0 0/0/0 0/0/0 0/0/0 0/0/0 0/0/0 0/0/0 0/0/1 0/0/0 0/0/0 0/0/0 0/0/0 0/0/0 0/0/0 0/0/0 0/0/4 0/0/4 0/0/4 0/0/1 0/0/4 0/0/4 0/0/0 0/0/0 0/0/1 0/0/0 0/0/0 0/0/0 0/0/0 1/0/1 0/0/0 0/0/0 0/0/0
0/0/0 1/0/1 0/0/3 0/0/0 0/0/0 0/0/0 0/0/0 0/0/0 0/0/0 0/0/0 0/0/0 0/0/0 0/0/1 0/0/0 0/0/0 0/0/0 0/0/0 0/0/0 0/0/0 0/0/0 0/0/0 0/0/0 0/0/0 0/0/1 0/0/0 0/0/0 0/0/0 0/0/0 0/0/0 0/0/0 0/0/0 0/0/0 0/0/0 0/0/0 0/0/1 0/0/0 0/0/0 0/0/0 0/0/0 0/0/0 0/0/0 0/0/0 0/0/0 0/0/0 0/0/1 0/0/0 0/0/0 0/0/0 0/0/0 0/0/0 0/0/0 0/0/0 0/0/0 0/0/0 0/0/0 0/0/1 0/0/0 0/0/0 0/0/0 0/0/0 0/0/0 0/0/0 0/0/0 0/0/4 0/0/4 0/0/4 0/0/1 0/0/0 0/0/0 0/0/0 0/0/0 0/0/1 0/0/4 0/0/4 0/0/0 0/0/0 1/0/1 0/0/0 0/0/0 0/0/0
0/0/0 1/0/1 0/0/3 0/0/3 0/0/0 0/0/0 0/0/0 0/0/0 0/0/0 0/0/0 0/0/0 0/0/0 0/0/1 0/0/0 0/0/0 0/0/0 0/0/0 0/0/0 0/0/0 0/0/0 0/0/0 0/0/0 0/0/0 0/0/1 0/0/0 0/0/0 0/0/0 0/0/0 0/0/0 0/0/0 0/0/0 0/0/0 0/0/0 0/0/0 0/0/1 0/0/0 0/0/0 0/0/0 0/0/0 0/0/0 0/0/0 0/0/0 0/0/0 0/0/0 0/0/1 0/0/0 0/0/0 0/0/0 0/0/0 0/0/0 0/0/0 0/0/0 0/0/0 0/0/0 0/0/0 0/0/1 0/0/0 0/0/0 0/0/0 0/0/0 0/0/0 0/0/0 0/0/0 0/0/0 0/0/0 0/0/0 0/0/1 0/0/0 0/0/0 0/0/0 0/0/0 0/0/1 0/0/4 0/0/4 0/0/0 0/0/0 1/0/1 0/0/0 0/0/0 0/0/0
0/0/0 1/0/1 0/0/3 0/0/3 0/0/0 0/0/0 0/0/0 0/0/0 0/0/0 0/0/0 0/0/0 0/0/0 0/0/1 0/0/0 0/0/0 0/0/0 0/0/0 0/0/0 0/0/0 0/0/0 0/0/0 0/0/0 0/0/0 0/0/1 0/0/0 0/0/0 0/0/0 0/0/0 0/0/0 0/0/0 0/0/0 0/0/0 0/0/0 0/0/0 0/0/1 0/0/0 0/0/0 0/0/0 0/0/0 0/0/0 0/0/0 0/0/0 0/0/0 0/0/0 0/0/1 0/0/0 0/0/0 0/0/0 0/0/0 0/0/0 0/0/0 0/0/0 0/0/0 0/0/0 0/0/0 0/0/1 0/0/0 0/0/0 0/0/0 0/0/0 0/0/0 0/0/0 0/0/0 0/0/0 0/0/0 0/0/0 0/0/1 0/0/0 0/0/0 0/0/0 0/0/0 0/0/1 0/0/4 0/0/4 0/0/0 0/0/0 1/0/1 0/0/0 0/0/0 0/0/0
0/0/0 1/0/1 1/0/1 1/0/1 1/0/1 1/0/1 1/0/1 1/0/1 1/0/1 1/0/1 1/0/1 1/0/1 1/0/1 1/0/1 1/0/1 1/0/1 1/0/1 1/0/1 1/0/1 1/0/1 1/0/1 1/0/1 1/0/1 1/0/1 1/0/1 1/0/1 1/0/1 1/0/1 1/0/1 1/0/1 1/0/1 1/0/1 1/0/1 1/0/1 1/0/1 1/0/1 1/0/1 1/0/1 1/0/1 1/0/1 1/0/1 1/0/1 1/0/1 1/0/1 1/0/1 1/0/1 1/0/1 1/0/1 1/0/1 1/0/1 1/0/1 1/0/1 1/0/1 1/0/1 1/0/1 1/0/1 1/0/1 1/0/1 1/0/1 1/0/1 1/0/1 1/0/1 1/0/1 1/0/1 1/0/1 1/0/1 1/0/1 1/0/1 1/0/1 1/0/1 1/0/1 1/0/1 1/0/1 1/0/1 1/0/1 1/0/1 1/0/1 0/0/0 0/0/0 0/0/0
0/0/0 0/0/0 0/0/0 0/0/0 0/0/0 0/0/0 0/0/0 0/0/0 0/0/0 0/0/0 0/0/0 0/0/0 0/0/0 0/0/0 0/0/0 0/0/0 0/0/0 0/0/0 0/0/0 0/0/0 0/0/0 0/0/0 0/0/0 0/0/0 0/0/0 0/0/0 0/0/0 0/0/0 0/0/0 0/0/0 0/0/0 0/0/0 0/0/0 0/0/0 0/0/0 0/0/0 0/0/0 0/0/0 0/0/0 0/0/0 0/0/0 0/0/0 0/0/0 0/0/0 0/0/0 0/0/0 0/0/0 0/0/0 0/0/0 0/0/0 0/0/0 0/0/0 0/0/0 0/0/0 0/0/0 0/0/0 0/0/0 0/0/0 0/0/0 0/0/0 0/0/0 0/0/0 0/0/0 0/0/0 0/0/0 0/0/0 0/0/0 0/0/0 0/0/0 0/0/0 0/0/0 0/0/0 0/0/0 0/0/0 0/0/0 0/0/0 0/0/0 0/0/0 0/0/0 0/0/0
0_1-38_76/132/100/0_34-0_35-0_36-0_37-14_76-15_76-16_76-17_76