0/0/0 0/0/0 0/0/0 0/0/0 0/0/0 0/0/0 0/0/0 0/0/0 0/0/0 0/0/0 0/0/0 0/0/0 0/0/0 0/0/0 0/0/0 0/0/0 0/0/0 0/0/0 0/0/0 0/0/0 0/0/0 0/0/0 0/0/0 0/0/0 0/0/0 0/0/0 0/0/0 0/0/0 0/0/0 0/0/0 0/0/0 0/0/0 0/0/0 0/0/0 0/0/0 0/0/0 0/0/0 0/0/0 0/0/0 0/0/0 0/0/0 0/0/0 0/0/0 0/0/0 0/0/0 0/0/0 0/0/0 0/0/0 0/0/0 0/0/0 0/0/0 0/0/0 0/0/0 0/0/0 0/0/0 0/0/0 0/0/0 0/0/0 0/0/0 0/0/0 0/0/0 0/0/0 0/0/0 0/0/0 0/0/0 0/0/0 0/0/0 0/0/0 0/0/0 0/0/0 0/0/0 0/0/0 0/0/0 0/0/0 0/0/0 0/0/0 0/0/0 0/0/0 0/0/0 0/0/0
0/0/0 0/0/0 0/0/0 0/0/0 1/0/1 1/0/1 1/0/1 1/0/1 1/0/1 1/0/1 1/0/1 1/0/1 1/0/1 1/0/1 1/0/1 1/0/1 1/0/1 1/0/1 1/0/1 1/0/1 1/0/1 1/0/1 1/0/1 1/0/1 1/0/1 1/0/1 1/0/1 1/0/1 1/0/1 1/0/1 1/0/1 1/0/1 1/0/1 1/0/1 1/0/2 1/0/2 1/0/2 1/0/2 1/0/2 1/0/2 1/0/2 1/0/2 1/0/1 1/0/1 1/0/1 1/0/1 1/0/1 1/0/1 1/0/1 1/0/1 1/0/1 1/0/1 1/0/1 1/0/1 1/0/1 1/0/1 1/0/1 1/0/1 1/0/1 1/0/1 1/0/1 1/0/1 1/0/1 1/0/1 1/0/1 1/0/1 1/0/1 1/0/1 1/0/1 1/0/1 1/0/1 1/0/1 1/0/1 1/0/1 1/0/1 1/0/1 0/0/0 0/0/0 0/0/0 0/0/0
0/0/0 0/0/0 0/0/0 0/0/0 1/0/1 0/0/0 0/0/0 0/0/0 0/0/0 0/0/0 0/0/0 0/0/1 0/0/0 0/0/0 0/0/0 0/0/0 0/0/0 0/0/0 0/0/0 0/0/0 0/0/0 0/0/0 0/0/0 0/0/0 0/0/0 0/0/0 0/0/0 0/0/0 0/0/0 0/0/0 0/0/0 0/0/0 0/0/0 0/0/0 0/0/0 0/0/0 0/0/0 0/0/0 0/0/0 0/0/0 0/0/0 0/0/0 0/0/0 0/0/0 0/0/0 0/0/0 0/0/0 0/0/0 0/0/0 0/0/0 0/0/0 0/0/0 0/0/0 0/0/0 0/0/0 0/0/0 0/0/0 0/0/0 0/0/0 0/0/0 0/0/0 0/0/0 0/0/0 0/0/0 0/0/0 0/0/0 0/0/0 0/0/0 0/0/0 0/0/0 0/0/0 0/0/0 0/0/0 0/0/0 0/0/0 1/0/1 0/0/0 0/0/0 0/0/0 0/0/0
0/0/0 0/0/0 0/0/0 0/0/0 1/0/1 0/0/0 0/0/0 0/0/0 0/0/0 0/0/0 0/0/0 0/0/1 0/0/0 0/0/0 0/0/0 0/0/0 0/0/0 0/0/0 0/0/0 0/0/0 0/0/0 0/0/0 0/0/0 0/0/0 0/0/0 0/0/0 0/0/0 0/0/0 0/0/0 0/0/0 0/0/0 0/0/0 0/0/0 0/0/0 0/0/0 0/0/0 0/0/0 0/0/0 0/0/0 0/0/0 0/0/0 0/0/0 0/0/0 0/0/0 0/0/0 0/0/0 0/0/0 0/0/0 0/0/0 0/0/0 0/0/0 0/0/0 0/0/0 0/0/0 0/0/0 0/0/0 0/0/0 0/0/0 0/0/0 0/0/0 0/0/0 0/0/0 0/0/0 0/0/0 0/0/0 0/0/0 0/0/0 0/0/0 0/0/0 0/0/0 0/0/0 0/0/0 0/0/0 0/0/0 0/0/0 1/0/1 0/0/0 0/0/0 0/0/0 0/0/0
0/0/0 0/0/0 0/0/0 0/0/0 1/0/1 0/0/0 0/0/0 0/0/0 0/0/0 0/0/0 0/0/0 0/0/1 0/0/0 0/0/0 0/0/0 0/0/0 0/0/0 0/0/0 0/0/0 0/0/0 0/0/0 0/0/0 0/0/0 0/0/0 0/0/0 0/0/0 0/0/0 0/0/0 0/0/0 0/0/0 0/0/0 0/0/0 0/0/0 0/0/0 0/0/0 0/0/0 0/0/0 0/0/0 0/0/0 0/0/0 0/0/0 0/0/0 0/0/0 0/0/0 0/0/0 0/0/0 0/0/0 0/0/0 0/0/0 0/0/0 0/0/0 0/0/0 0/0/0 0/0/0 0/0/0 0/0/0 0/0/0 0/0/0 0/0/0 0/0/0 0/0/0 0/0/0 0/0/0 0/0/0 0/0/0 0/0/0 0/0/0 0/0/0 0/0/0 0/0/0 0/0/0 0/0/0 0/0/0 0/0/0 0/0/0 1/0/1 0/0/0 0/0/0 0/0/0 0/0/0
0/0/0 0/0/0 0/0/0 0/0/0 1/0/1 0/0/0 0/0/0 0/0/0 0/0/0 0/0/0 0/0/0 0/0/1 0/0/0 0/0/0 0/0/0 0/0/0 0/0/0 0/0/0 0/0/0 0/0/0 0/0/0 0/0/0 0/0/0 0/0/0 0/0/0 0/0/0 0/0/0 0/0/0 0/0/0 0/0/0 0/0/0 0/0/0 0/0/0 0/0/0 0/0/0 0/0/0 0/0/0 0/0/0 0/0/0 0/0/0 0/0/0 0/0/0 0/0/0 0/0/0 0/0/0 0/0/0 0/0/0 0/0/0 0/0/0 0/0/0 0/0/0 0/0/0 0/0/0 0/0/0 0/0/0 0/0/0 0/0/0 0/0/1 0/0/0 0/0/0 0/0/0 0/0/0 0/0/0 0/0/0 0/0/0 0/0/0 0/0/0 0/0/0 0/0/0 0/0/0 0/0/0 0/0/0 0/0/0 0/0/0 0/0/0 1/0/1 0/0/0 0/0/0 0/0/0 0/0/0
0/0/0 0/0/0 0/0/0 0/0/0 1/0/1 0/0/0 0/0/0 0/0/0 0/0/0 0/0/0 0/0/0 0/0/1 0/0/0 0/0/0 0/0/0 0/0/0 0/0/0 0/0/0 0/0/0 0/0/1 0/0/1 0/0/1 0/0/1 0/0/1 0/0/1 0/0/1 0/0/1 0/0/1 0/0/1 0/0/1 0/0/1 0/0/1 0/0/1 0/0/1 0/0/1 0/0/1 0/0/1 0/0/1 0/0/1 0/0/1 0/0/1 0/0/1 0/0/1 0/0/1 0/0/1 0/0/1 0/0/1 0/0/1 0/0/1 0/0/1 0/0/1 0/0/1 0/0/0 0/0/0 0/0/0 0/0/0 0/0/0 0/0/1 0/0/0 0/0/0 0/0/0 0/0/0 0/0/0 0/0/0 0/0/0 0/0/0 0/0/0 0/0/0 0/0/0 0/0/0 0/0/0 0/0/0 0/0/0 0/0/0 0/0/0 1/0/1 0/0/0 0/0/0 0/0/0 0/0/0
0/0/0 0/0/0 0/0/0 0/0/0 1/0/1 0/0/0 0/0/0 0/0/0 0/0/0 0/0/0 0/0/0 0/0/1 0/0/0 0/0/0 0/0/0 0/0/0 0/0/0 0/0/0 0/0/0 0/0/0 0/0/0 0/0/0 0/0/0 0/0/0 0/0/3 0/0/3 0/0/3 0/0/3 0/0/3 0/0/3 0/0/3 0/0/3 0/0/3 0/0/3 0/0/3 0/0/3 0/0/3 0/0/3 0/0/3 0/0/3 0/0/3 0/0/3 0/0/3 0/0/3 0/0/3 0/0/3 0/0/3 0/0/3 0/0/3 0/0/3 0/0/3 0/0/1 0/0/0 0/0/0 0/0/0 0/0/0 0/0/0 0/0/1 0/0/0 0/0/0 0/0/0 0/0/0 0/0/0 0/0/0 0/0/0 0/0/0 0/0/0 0/0/0 0/0/0 0/0/0 0/0/0 0/0/0 0/0/0 0/0/0 0/0/0 1/0/1 0/0/0 0/0/0 0/0/0 0/0/0
0/0/0 0/0/0 0/0/0 0/0/0 1/0/1 0/0/0 0/0/0 0/0/0 0/0/0 0/0/0 0/0/0 0/0/0 0/0/0 0/0/0 0/0/0 0/0/0 0/0/0 0/0/0 0/0/0 0/0/0 0/0/0 0/0/0 0/0/0 0/0/0 0/0/0 0/0/0 0/0/0 0/0/0 0/0/0 0/0/0 0/0/0 0/0/0 0/0/0 0/0/0 0/0/0 0/0/0 0/0/0 0/0/0 0/0/0 0/0/0 0/0/0 0/0/0 0/0/0 0/0/0 0/0/0 0/0/0 0/0/0 0/0/0 0/0/0 0/0/0 0/0/3 0/0/1 0/0/0 0/0/0 0/0/0 0/0/0 0/0/0 0/0/1 0/0/0 0/0/0 0/0/0 0/0/0 0/0/0 0/0/0 0/0/0 0/0/0 0/0/0 0/0/0 0/0/0 0/0/0 0/0/0 0/0/0 0/0/0 0/0/0 0/0/0 1/0/1 0/0/0 0/0/0 0/0/0 0/0/0
0/0/0 0/0/0 0/0/0 0/0/0 1/0/1 0/0/0 0/0/0 0/0/0 0/0/0 0/0/0 0/0/0 0/0/0 0/0/0 0/0/0 0/0/0 0/0/0 0/0/0 0/0/0 0/0/0 0/0/1 0/0/0 0/0/0 0/0/0 0/0/0 0/0/0 0/0/0 0/0/0 0/0/0 0/0/0 0/0/0 0/0/0 0/0/0 0/0/0 0/0/0 0/0/0 0/0/0 0/0/0 0/0/0 0/0/0 0/0/0 0/0/0 0/0/0 0/0/0 0/0/0 0/0/0 0/0/0 0/0/0 0/0/0 0/0/0 0/0/0 0/0/3 0/0/1 0/0/0 0/0/0 0/0/0 0/0/0 0/0/0 0/0/1 0/0/0 0/0/0 0/0/0 0/0/0 0/0/0 0/0/0 0/0/0 0/0/0 0/0/0 0/0/0 0/0/0 0/0/0 0/0/0 0/0/0 0/0/0 0/0/0 0/0/0 1/0/1 0/0/0 0/0/0 0/0/0 0/0/0
0/0/0 0/0/0 0/0/0 0/0/0 1/0/1 0/0/1 0/0/1 0/0/1 0/0/1 0/0/1 0/0/1 0/0/1 0/0/0 0/0/0 0/0/0 0/0/0 0/0/0 0/0/0 0/0/0 0/0/1 0/0/0 0/0/0 0/0/0 0/0/0 0/0/0 0/0/0 0/0/0 0/0/3 0/0/0 0/0/0 0/0/0 0/0/0 0/0/3 0/0/0 0/0/0 0/0/0 0/0/0 0/0/3 0/0/0 0/0/0 0/0/0 0/0/0 0/0/3 0/0/0 0/0/0 0/0/0 0/0/0 0/0/0 0/0/0 0/0/0 0/0/3 0/0/1 0/0/0 0/0/0 0/0/0 0/0/0 0/0/0 0/0/1 0/0/0 0/0/0 0/0/0 0/0/0 0/0/0 0/0/0 0/0/0 0/0/0 0/0/0 0/0/0 0/0/0 0/0/0 0/0/0 0/0/0 0/0/0 0/0/0 0/0/0 1/0/1 0/0/0 0/0/0 0/0/0 0/0/0
0/0/0 0/0/0 0/0/0 0/0/0 1/0/1 0/0/0 0/0/0 0/0/0 0/0/0 0/0/0 0/0/0 0/0/0 0/0/0 0/0/0 0/0/0 0/0/0 0/0/0 0/0/0 0/0/0 0/0/1 0/0/0 0/0/0 0/0/0 0/0/0 0/0/0 0/0/0 0/0/0 0/0/3 0/0/0 0/0/0 0/0/0 0/0/0 0/0/3 0/0/0 0/0/0 0/0/0 0/0/0 0/0/3 0/0/0 0/0/0 0/0/0 0/0/0 0/0/3 0/0/0 0/0/0 0/0/0 0/0/0 0/0/0 0/0/0 0/0/0 0/0/3 0/0/1 0/0/0 0/0/0 0/0/0 0/0/0 0/0/0 0/0/1 0/0/0 0/0/0 0/0/0 0/0/0 0/0/0 0/0/0 0/0/0 0/0/0 0/0/0 0/0/0 0/0/0 0/0/0 0/0/0 0/0/0 0/0/0 0/0/0 0/0/0 1/0/1 0/0/0 0/0/0 0/0/0 0/0/0
0/0/0 0/0/0 0/0/0 0/0/0 1/0/1 0/0/0 0/0/0 0/0/0 0/0/0 0/0/0 0/0/0 0/0/0 0/0/0 0/0/0 0/0/0 0/0/0 0/0/0 0/0/0 0/0/0 0/0/1 0/0/1 0/0/1 0/0/1 0/0/0 0/0/0 0/0/0 0/0/0 0/0/3 0/0/0 0/0/0 0/0/0 0/0/0 0/0/3 0/0/0 0/0/0 0/0/0 0/0/0 0/0/3 0/0/0 0/0/0 0/0/0 0/0/0 0/0/3 0/0/0 0/0/0 0/0/0 0/0/0 0/0/0 0/0/0 0/0/0 0/0/3 0/0/1 0/0/0 0/0/0 0/0/0 0/0/0 0/0/0 0/0/1 0/0/0 0/0/0 0/0/0 0/0/0 0/0/0 0/0/0 0/0/0 0/0/0 0/0/0 0/0/0 0/0/0 0/0/0 0/0/0 0/0/0 0/0/0 0/0/0 0/0/0 1/0/1 0/0/0 0/0/0 0/0/0 0/0/0
0/0/0 0/0/0 0/0/0 0/0/0 1/0/1 0/0/4 0/0/4 0/0/4 0/0/0 0/0/0 0/0/0 0/0/1 0/0/0 0/0/0 0/0/0 0/0/0 0/0/0 0/0/0 0/0/0 0/0/0 0/0/0 0/0/0 0/0/1 0/0/0 0/0/0 0/0/0 0/0/0 0/0/3 0/0/0 0/0/0 0/0/0 0/0/0 0/0/3 0/0/0 0/0/0 0/0/0 0/0/0 0/0/3 0/0/0 0/0/0 0/0/0 0/0/0 0/0/3 0/0/0 0/0/0 0/0/0 0/0/0 0/0/0 0/0/0 0/0/0 0/0/3 0/0/1 0/0/0 0/0/0 0/0/0 0/0/0 0/0/0 0/0/1 0/0/0 0/0/0 0/0/0 0/0/0 0/0/0 0/0/0 0/0/0 0/0/0 0/0/0 0/0/0 0/0/0 0/0/0 0/0/0 0/0/0 0/0/0 0/0/0 0/0/0 1/0/1 0/0/0 0/0/0 0/0/0 0/0/0
0/0/0 0/0/0 0/0/0 0/0/0 1/0/1 0/0/4 0/0/4 0/0/4 0/0/0 0/0/0 0/0/0 0/0/1 0/0/0 0/0/0 0/0/0 0/0/0 0/0/0 0/0/0 0/0/0 0/0/0 0/0/0 0/0/0 0/0/1 0/0/0 0/0/0 0/0/0 0/0/0 0/0/3 0/0/0 0/0/0 0/0/0 0/0/0 0/0/3 0/0/0 0/0/0 0/0/0 0/0/0 0/0/3 0/0/0 0/0/0 0/0/0 0/0/0 0/0/3 0/0/0 0/0/0 0/0/0 0/0/0 0/0/0 0/0/0 0/0/0 0/0/3 0/0/1 0/0/0 0/0/0 0/0/0 0/0/0 0/0/0 0/0/1 0/0/0 0/0/0 0/0/0 0/0/0 0/0/0 0/0/0 0/0/0 0/0/0 0/0/0 0/0/0 0/0/0 0/0/0 0/0/0 0/0/0 0/0/0 0/0/0 0/0/0 1/0/1 0/0/0 0/0/0 0/0/0 0/0/0
0/0/0 0/0/0 0/0/0 0/0/0 1/0/1 0/0/0 0/0/0 0/0/0 0/0/0 0/0/0 0/0/0 0/0/1 0/0/0 0/0/0 0/0/0 0/0/0 0/0/0 0/0/0 0/0/0 0/0/0 0/0/0 0/0/0 0/0/1 0/0/0 0/0/0 0/0/0 0/0/0 0/0/3 0/0/0 0/0/0 0/0/0 0/0/0 0/0/3 0/0/0 0/0/0 0/0/0 0/0/0 0/0/3 0/0/0 0/0/0 0/0/0 0/0/0 0/0/3 0/0/0 0/0/0 0/0/0 0/0/0 0/0/0 0/0/0 0/0/0 0/0/3 0/0/1 0/0/0 0/0/0 0/0/0 0/0/0 0/0/0 0/0/1 0/0/0 0/0/0 0/0/0 0/0/1 0/0/1 0/0/1 0/0/1 0/0/1 0/0/1 0/0/1 0/0/1 0/0/1 0/0/1 0/0/1 0/0/1 0/0/1 0/0/1 1/0/1 0/0/0 0/0/0 0/0/0 0/0/0
0/0/0 0/0/0 0/0/0 0/0/0 1/0/1 0/0/4 0/0/4 0/0/4 0/0/0 0/0/0 0/0/0 0/0/1 0/0/0 0/0/0 0/0/0 0/0/0 0/0/0 0/0/0 0/0/0 0/0/0 0/0/0 0/0/0 0/0/1 0/0/0 0/0/0 0/0/0 0/0/0 0/0/3 0/0/0 0/0/0 0/0/0 0/0/0 0/0/3 0/0/0 0/0/0 0/0/0 0/0/0 0/0/3 0/0/0 0/0/0 0/0/0 0/0/0 0/0/3 0/0/0 0/0/0 0/0/0 0/0/0 0/0/0 0/0/0 0/0/0 0/0/3 0/0/1 0/0/0 0/0/0 0/0/0 0/0/0 0/0/0 0/0/0 0/0/0 0/0/0 0/0/0 0/0/0 0/0/0 0/0/0 0/0/0 0/0/0 0/0/0 0/0/0 0/0/0 0/0/0 0/0/0 0/0/0 0/0/0 0/0/0 0/0/0 1/0/2 0/0/0 0/0/0 0/0/0 0/0/0
0/0/0 0/0/0 0/0/0 0/0/0 1/0/1 0/0/4 0/0/4 0/0/4 0/0/0 0/0/0 0/0/0 0/0/1 0/0/0 0/0/0 0/0/0 0/0/0 0/0/0 0/0/0 0/0/0 0/0/0 0/0/0 0/0/0 0/0/1 0/0/0 0/0/0 0/0/0 0/0/0 0/0/3 0/0/0 0/0/0 0/0/0 0/0/0 0/0/3 0/0/0 0/0/0 0/0/0 0/0/0 0/0/3 0/0/0 0/0/0 0/0/0 0/0/0 0/0/3 0/0/0 0/0/0 0/0/0 0/0/0 0/0/0 0/0/0 0/0/0 0/0/3 0/0/1 0/0/0 0/0/0 0/0/0 0/0/0 0/0/0 0/0/0 0/0/0 0/0/0 0/0/0 0/0/0 0/0/0 0/0/0 0/0/0 0/0/0 0/0/0 0/0/0 0/0/0 0/0/0 0/0/0 0/0/0 0/0/0 0/0/0 0/0/0 1/0/2 0/0/0 0/0/0 0/0/0 0/0/0
0/0/0 0/0/0 0/0/0 0/0/0 1/0/1 0/0/0 0/0/0 0/0/0 0/0/0 0/0/0 0/0/0 0/0/1 0/0/0 0/0/0 0/0/0 0/0/0 0/0/0 0/0/0 0/0/0 0/0/0 0/0/0 0/0/0 0/0/1 0/0/0 0/0/0 0/0/0 0/0/0 0/0/0 0/0/0 0/0/0 0/0/0 0/0/0 0/0/0 0/0/0 0/0/0 0/0/0 0/0/0 0/0/0 0/0/0 0/0/0 0/0/0 0/0/0 0/0/0 0/0/0 0/0/0 0/0/0 0/0/0 0/0/0 0/0/0 0/0/0 0/0/3 0/0/1 0/0/0 0/0/0 0/0/0 0/0/0 0/0/0 0/0/0 0/0/0 0/0/0 0/0/0 0/0/0 0/0/0 0/0/0 0/0/0 0/0/0 0/0/0 0/0/0 0/0/0 0/0/0 0/0/0 0/0/0 0/0/0 0/0/0 0/0/0 1/0/2 0/0/0 0/0/0 0/0/0 0/0/0
0/0/0 0/0/0 0/0/0 0/0/0 1/0/1 0/0/1 0/0/1 0/0/1 0/0/1 0/0/1 0/0/1 0/0/1 0/0/1 0/0/1 0/0/1 0/0/1 0/0/0 0/0/0 0/0/0 0/0/0 0/0/0 0/0/0 0/0/1 0/0/0 0/0/0 0/0/0 0/0/0 0/0/0 0/0/0 0/0/0 0/0/0 0/0/0 0/0/0 0/0/0 0/0/0 0/0/0 0/0/0 0/0/0 0/0/0 0/0/0 0/0/0 0/0/0 0/0/0 0/0/0 0/0/0 0/0/0 0/0/0 0/0/0 0/0/0 0/0/0 0/0/0 0/0/0 0/0/0 0/0/0 0/0/0 0/0/0 0/0/0 0/0/0 0/0/0 0/0/0 0/0/0 0/0/0 0/0/0 0/0/0 0/0/0 0/0/0 0/0/0 0/0/0 0/0/0 0/0/0 0/0/0 0/0/0 0/0/0 0/0/0 0/0/0 1/0/2 0/0/0 0/0/0 0/0/0 0/0/0
0/0/0 0/0/0 0/0/0 0/0/0 1/0/1 0/0/0 0/0/0 0/0/0 0/0/0 0/0/0 0/0/0 0/0/0 0/0/0 0/0/0 0/0/0 0/0/1 0/0/0 0/0/0 0/0/0 0/0/0 0/0/0 0/0/0 0/0/1 0/0/3 0/0/3 0/0/3 0/0/3 0/0/3 0/0/3 0/0/3 0/0/3 0/0/3 0/0/3 0/0/3 0/0/3 0/0/3 0/0/3 0/0/3 0/0/3 0/0/3 0/0/3 0/0/3 0/0/3 0/0/3 0/0/3 0/0/3 0/0/3 0/0/3 0/0/3 0/0/0 0/0/0 0/0/0 0/0/0 0/0/0 0/0/0 0/0/0 0/0/0 0/0/0 0/0/0 0/0/0 0/0/0 0/0/0 0/0/0 0/0/0 0/0/0 0/0/0 0/0/0 0/0/0 0/0/0 0/0/0 0/0/0 0/0/0 0/0/0 0/0/0 0/0/0 1/0/2 0/0/0 0/0/0 0/0/0 0/0/0
0/0/0 0/0/0 0/0/0 0/0/0 1/0/1 0/0/0 0/0/0 0/0/0 0/0/0 0/0/0 0/0/0 0/0/0 0/0/0 0/0/0 0/0/0 0/0/1 0/0/0 0/0/0 0/0/0 0/0/0 0/0/0 0/0/0 0/0/1 0/0/1 0/0/1 0/0/1 0/0/1 0/0/1 0/0/1 0/0/1 0/0/1 0/0/1 0/0/1 0/0/1 0/0/1 0/0/1 0/0/1 0/0/1 0/0/1 0/0/1 0/0/1 0/0/1 0/0/1 0/0/1 0/0/1 0/0/1 0/0/1 0/0/1 0/0/1 0/0/1 0/0/1 0/0/1 0/0/0 0/0/0 0/0/0 0/0/0 0/0/0 0/0/0 0/0/0 0/0/0 0/0/0 0/0/0 0/0/0 0/0/1 0/0/1 0/0/1 0/0/1 0/0/1 0/0/1 0/0/1 0/0/1 0/0/1 0/0/1 0/0/1 0/0/1 1/0/1 0/0/0 0/0/0 0/0/0 0/0/0
0/0/0 0/0/0 0/0/0 0/0/0 1/0/1 0/0/3 0/0/3 0/0/0 0/0/0 0/0/0 0/0/0 0/0/0 0/0/0 0/0/0 0/0/0 0/0/1 0/0/0 0/0/0 0/0/0 0/0/0 0/0/0 0/0/0 0/0/0 0/0/0 0/0/0 0/0/0 0/0/0 0/0/0 0/0/0 0/0/0 0/0/0 0/0/0 0/0/0 0/0/0 0/0/0 0/0/0 0/0/0 0/0/0 0/0/0 0/0/0 0/0/0 0/0/0 0/0/0 0/0/0 0/0/0 0/0/0 0/0/0 0/0/0 0/0/0 0/0/0 0/0/0 0/0/0 0/0/0 0/0/0 0/0/0 0/0/0 0/0/0 0/0/0 0/0/0 0/0/0 0/0/0 0/0/0 0/0/0 0/0/0 0/0/0 0/0/0 0/0/0 0/0/0 0/0/0 0/0/0 0/0/0 0/0/0 0/0/0 0/0/0 0/0/0 1/0/1 0/0/0 0/0/0 0/0/0 0/0/0
0/0/0 0/0/0 0/0/0 0/0/0 1/0/1 0/0/3 0/0/3 0/0/0 0/0/0 0/0/0 0/0/0 0/0/0 0/0/0 0/0/0 0/0/0 0/0/1 0/0/0 0/0/0 0/0/0 0/0/0 0/0/0 0/0/0 0/0/0 0/0/0 0/0/0 0/0/0 0/0/0 0/0/0 0/0/0 0/0/0 0/0/0 0/0/0 0/0/0 0/0/0 0/0/0 0/0/0 0/0/0 0/0/0 0/0/0 0/0/0 0/0/0 0/0/0 0/0/0 0/0/0 0/0/0 0/0/0 0/0/0 0/0/0 0/0/0 0/0/0 0/0/0 0/0/0 0/0/0 0/0/0 0/0/0 0/0/0 0/0/0 0/0/0 0/0/0 0/0/0 0/0/0 0/0/0 0/0/0 0/0/0 0/0/0 0/0/0 0/0/0 0/0/0 0/0/0 0/0/0 0/0/0 0/0/0 0/0/0 0/0/0 0/0/0 1/0/1 0/0/0 0/0/0 0/0/0 0/0/0
0/0/0 0/0/0 0/0/0 0/0/0 1/0/1 0/0/3 0/0/3 0/0/0 0/0/0 0/0/0 0/0/0 0/0/0 0/0/0 0/0/0 0/0/0 0/0/1 0/0/0 0/0/0 0/0/0 0/0/0 0/0/0 0/0/0 0/0/0 0/0/0 0/0/0 0/0/0 0/0/0 0/0/0 0/0/0 0/0/0 0/0/0 0/0/0 0/0/0 0/0/0 0/0/0 0/0/0 0/0/0 0/0/0 0/0/0 0/0/0 0/0/0 0/0/0 0/0/0 0/0/0 0/0/0 0/0/0 0/0/0 0/0/0 0/0/0 0/0/0 0/0/0 0/0/0 0/0/0 0/0/0 0/0/0 0/0/0 0/0/0 0/0/0 0/0/0 0/0/0 0/0/0 0/0/0 0/0/0 0/0/1 0/0/0 0/0/0 0/0/0 0/0/0 0/0/0 0/0/0 0/0/0 0/0/0 0/0/0 0/0/0 0/0/0 1/0/1 0/0/0 0/0/0 0/0/0 0/0/0
0/0/0 0/0/0 0/0/0 0/0/0 1/0/1 0/0/3 0/0/3 0/0/0 0/0/0 0/0/0 0/0/0 0/0/0 0/0/0 0/0/0 0/0/0 0/0/1 0/0/0 0/0/0 0/0/0 0/0/0 0/0/0 0/0/0 0/0/0 0/0/0 0/0/0 0/0/0 0/0/0 0/0/0 0/0/0 0/0/0 0/0/0 0/0/0 0/0/0 0/0/0 0/0/0 0/0/0 0/0/0 0/0/0 0/0/0 0/0/0 0/0/0 0/0/0 0/0/0 0/0/0 0/0/0 0/0/0 0/0/0 0/0/0 0/0/0 0/0/0 0/0/0 0/0/0 0/0/0 0/0/0 0/0/0 0/0/0 0/0/0 0/0/0 0/0/0 0/0/0 0/0/0 0/0/0 0/0/0 0/0/1 0/0/0 0/0/0 0/0/0 0/0/0 0/0/0 0/0/0 0/0/0 0/0/0 0/0/0 0/0/0 0/0/0 1/0/1 0/0/0 0/0/0 0/0/0 0/0/0
0/0/0 0/0/0 0/0/0 0/0/0 1/0/1 0/0/3 0/0/3 0/0/0 0/0/0 0/0/0 0/0/0 0/0/0 0/0/0 0/0/0 0/0/0 0/0/0 0/0/0 0/0/0 0/0/0 0/0/0 0/0/0 0/0/0 0/0/0 0/0/0 0/0/0 0/0/0 0/0/0 0/0/0 0/0/0 0/0/0 0/0/0 0/0/0 0/0/0 0/0/0 0/0/0 0/0/0 0/0/0 0/0/0 0/0/0 0/0/0 0/0/0 0/0/0 0/0/0 0/0/0 0/0/0 0/0/0 0/0/0 0/0/0 0/0/0 0/0/0 0/0/0 0/0/0 0/0/0 0/0/0 0/0/0 0/0/0 0/0/0 0/0/0 0/0/0 0/0/0 0/0/0 0/0/0 0/0/0 0/0/1 0/0/0 0/0/0 0/0/0 0/0/0 0/0/0 0/0/0 0/0/0 0/0/0 0/0/0 0/0/0 0/0/0 1/0/1 0/0/0 0/0/0 0/0/0 0/0/0
0/0/0 0/0/0 0/0/0 0/0/0 1/0/1 0/0/3 0/0/3 0/0/0 0/0/0 0/0/0 0/0/0 0/0/0 0/0/0 0/0/0 0/0/0 0/0/0 0/0/0 0/0/0 0/0/0 0/0/0 0/0/0 0/0/0 0/0/0 0/0/0 0/0/0 0/0/0 0/0/0 0/0/0 0/0/0 0/0/0 0/0/0 0/0/0 0/0/0 0/0/0 0/0/0 0/0/0 0/0/0 0/0/0 0/0/0 0/0/0 0/0/0 0/0/0 0/0/0 0/0/0 0/0/0 0/0/0 0/0/0 0/0/0 0/0/0 0/0/0 0/0/0 0/0/0 0/0/0 0/0/0 0/0/0 0/0/0 0/0/0 0/0/0 0/0/0 0/0/0 0/0/0 0/0/0 0/0/0 0/0/1 0/0/0 0/0/0 0/0/0 0/0/0 0/0/0 0/0/0 0/0/0 0/0/0 0/0/0 0/0/0 0/0/0 1/0/1 0/0/0 0/0/0 0/0/0 0/0/0
0/0/0 0/0/0 0/0/0 0/0/0 1/0/1 0/0/3 0/0/3 0/0/0 0/0/0 0/0/0 0/0/0 0/0/0 0/0/0 0/0/0 0/0/0 0/0/1 0/0/1 0/0/1 0/0/1 0/0/1 0/0/1 0/0/1 0/0/1 0/0/0 0/0/0 0/0/1 0/0/0 0/0/0 0/0/1 0/0/1 0/0/1 0/0/1 0/0/1 0/0/1 0/0/1 0/0/1 0/0/1 0/0/0 0/0/0 0/0/1 0/0/0 0/0/0 0/0/1 0/0/1 0/0/1 0/0/1 0/0/1 0/0/1 0/0/1 0/0/1 0/0/1 0/0/1 0/0/1 0/0/0 0/0/0 0/0/1 0/0/0 0/0/0 0/0/1 0/0/1 0/0/1 0/0/1 0/0/1 0/0/1 0/0/0 0/0/0 0/0/0 0/0/0 0/0/0 0/0/0 0/0/0 0/0/0 0/0/0 0/0/0 0/0/0 1/0/1 0/0/0 0/0/0 0/0/0 0/0/0
0/0/0 0/0/0 0/0/0 0/0/0 1/0/1 0/0/3 0/0/3 0/0/0 0/0/0 0/0/0 0/0/0 0/0/0 0/0/0 0/0/0 0/0/0 0/0/1 0/0/0 0/0/0 0/0/4 0/0/4 0/0/0 0/0/0 0/0/0 0/0/0 0/0/0 0/0/1 0/0/0 0/0/0 0/0/0 0/0/0 0/0/0 0/0/0 0/0/1 0/0/0 0/0/0 0/0/0 0/0/0 0/0/0 0/0/0 0/0/1 0/0/0 0/0/0 0/0/0 0/0/0 0/0/0 0/0/0 0/0/0 0/0/1 0/0/0 0/0/0 0/0/0 0/0/0 0/0/0 0/0/0 0/0/0 0/0/1 0/0/0 0/0/0 0/0/0 0/0/0 0/0/0 0/0/0 0/0/0 0/0/1 0/0/0 0/0/0 0/0/0 0/0/0 0/0/0 0/0/0 0/0/0 0/0/0 0/0/0 0/0/0 0/0/0 1/0/1 0/0/0 0/0/0 0/0/0 0/0/0
0/0/0 0/0/0 0/0/0 0/0/0 1/0/1 0/0/3 0/0/3 0/0/0 0/0/0 0/0/0 0/0/0 0/0/0 0/0/0 0/0/0 0/0/0 0/0/1 0/0/0 0/0/0 0/0/4 0/0/4 0/0/0 0/0/0 0/0/0 0/0/0 0/0/0 0/0/1 0/0/0 0/0/0 0/0/0 0/0/4 0/0/4 0/0/4 0/0/1 0/0/4 0/0/4 0/0/4 0/0/0 0/0/0 0/0/0 0/0/1 0/0/0 0/0/0 0/0/0 0/0/0 0/0/4 0/0/4 0/0/4 0/0/1 0/0/4 0/0/4 0/0/4 0/0/0 0/0/0 0/0/0 0/0/0 0/0/1 0/0/0 0/0/0 0/0/0 0/0/0 0/0/4 0/0/4 0/0/4 0/0/1 0/0/1 0/0/1 0/0/1 0/0/0 0/0/0 0/0/1 0/0/0 0/0/0 0/0/1 0/0/1 0/0/1 1/0/1 0/0/0 0/0/0 0/0/0 0/0/0
0/0/0 0/0/0 0/0/0 0/0/0 1/0/1 0/0/3 0/0/3 0/0/0 0/0/0 0/0/0 0/0/0 0/0/0 0/0/0 0/0/0 0/0/0 0/0/1 0/0/0 0/0/0 0/0/4 0/0/4 0/0/0 0/0/0 0/0/0 0/0/0 0/0/0 0/0/1 0/0/0 0/0/0 0/0/0 0/0/4 0/0/4 0/0/4 0/0/1 0/0/4 0/0/4 0/0/4 0/0/0 0/0/0 0/0/0 0/0/1 0/0/0 0/0/0 0/0/0 0/0/0 0/0/4 0/0/4 0/0/4 0/0/1 0/0/4 0/0/4 0/0/4 0/0/0 0/0/0 0/0/0 0/0/0 0/0/1 0/0/0 0/0/0 0/0/0 0/0/0 0/0/4 0/0/4 0/0/4 0/0/1 0/0/4 0/0/0 0/0/0 0/0/0 0/0/0 0/0/1 0/0/0 0/0/0 0/0/0 0/0/0 0/0/4 1/0/1 0/0/0 0/0/0 0/0/0 0/0/0
0/0/0 0/0/0 0/0/0 0/0/0 1/0/1 0/0/3 0/0/3 0/0/0 0/0/0 0/0/0 0/0/0 0/0/0 0/0/0 0/0/0 0/0/0 0/0/1 0/0/4 0/0/4 0/0/4 0/0/0 0/0/0 0/0/0 0/0/0 0/0/0 0/0/0 0/0/1 0/0/0 0/0/0 0/0/0 0/0/0 0/0/0 0/0/0 0/0/1 0/0/0 0/0/0 0/0/0 0/0/0 0/0/0 0/0/0 0/0/1 0/0/0 0/0/0 0/0/0 0/0/0 0/0/0 0/0/0 0/0/0 0/0/1 0/0/0 0/0/0 0/0/0 0/0/0 0/0/0 0/0/0 0/0/0 0/0/1 0/0/0 0/0/0 0/0/0 0/0/0 0/0/0 0/0/0 0/0/0 0/0/1 0/0/4 0/0/0 0/0/0 0/0/0 0/0/0 0/0/1 0/0/0 0/0/0 0/0/0 0/0/0 0/0/4 1/0/1 0/0/0 0/0/0 0/0/0 0/0/0
0/0/0 0/0/0 0/0/0 0/0/0 1/0/1 0/0/3 0/0/3 0/0/0 0/0/0 0/0/0 0/0/0 0/0/0 0/0/0 0/0/0 0/0/0 0/0/1 0/0/4 0/0/4 0/0/4 0/0/0 0/0/0 0/0/0 0/0/0 0/0/0 0/0/0 0/0/1 0/0/0 0/0/0 0/0/0 0/0/4 0/0/4 0/0/4 0/0/1 0/0/4 0/0/4 0/0/4 0/0/0 0/0/0 0/0/0 0/0/1 0/0/0 0/0/0 0/0/0 0/0/0 0/0/4 0/0/4 0/0/4 0/0/1 0/0/4 0/0/4 0/0/4 0/0/0 0/0/0 0/0/0 0/0/0 0/0/1 0/0/0 0/0/0 0/0/0 0/0/0 0/0/4 0/0/4 0/0/4 0/0/1 0/0/4 0/0/0 0/0/0 0/0/0 0/0/0 0/0/1 0/0/0 0/0/0 0/0/0 0/0/0 0/0/4 1/0/1 0/0/0 0/0/0 0/0/0 0/0/0
0/0/0 0/0/0 0/0/0 0/0/0 1/0/1 0/0/3 0/0/3 0/0/0 0/0/0 0/0/0 0/0/0 0/0/0 0/0/0 0/0/0 0/0/0 0/0/1 0/0/0 0/0/0 0/0/0 0/0/0 0/0/0 0/0/0 0/0/0 0/0/0 0/0/0 0/0/1 0/0/0 0/0/0 0/0/0 0/0/4 0/0/4 0/0/4 0/0/1 0/0/4 0/0/4 0/0/4 0/0/0 0/0/0 0/0/0 0/0/1 0/0/0 0/0/0 0/0/0 0/0/0 0/0/4 0/0/4 0/0/4 0/0/1 0/0/4 0/0/4 0/0/4 0/0/0 0/0/0 0/0/0 0/0/0 0/0/1 0/0/0 0/0/0 0/0/0 0/0/0 0/0/4 0/0/4 0/0/4 0/0/1 0/0/0 0/0/0 0/0/0 0/0/0 0/0/0 0/0/1 0/0/0 0/0/0 0/0/0 0/0/0 0/0/0 1/0/1 0/0/0 0/0/0 0/0/0 0/0/0
0/0/0 0/0/0 0/0/0 0/0/0 1/0/1 0/0/3 0/0/3 0/0/0 0/0/0 0/0/0 0/0/0 0/0/0 0/0/0 0/0/0 0/0/0 0/0/1 0/0/4 0/0/4 0/0/4 0/0/0 0/0/0 0/0/0 0/0/0 0/0/0 0/0/0 0/0/1 0/0/0 0/0/0 0/0/0 0/0/0 0/0/0 0/0/0 0/0/1 0/0/0 0/0/0 0/0/0 0/0/0 0/0/0 0/0/0 0/0/1 0/0/0 0/0/0 0/0/0 0/0/0 0/0/0 0/0/0 0/0/0 0/0/1 0/0/0 0/0/0 0/0/0 0/0/0 0/0/0 0/0/0 0/0/0 0/0/1 0/0/0 0/0/0 0/0/0 0/0/0 0/0/0 0/0/0 0/0/0 0/0/1 0/0/4 0/0/4 0/0/4 0/0/0 0/0/0 0/0/1 0/0/0 0/0/0 0/0/4 0/0/4 0/0/4 1/0/1 0/0/0 0/0/0 0/0/0 0/0/0
0/0/0 0/0/0 0/0/0 0/0/0 1/0/1 0/0/3 0/0/3 0/0/0 0/0/0 0/0/0 0/0/0 0/0/0 0/0/0 0/0/0 0/0/0 0/0/1 0/0/4 0/0/4 0/0/4 0/0/0 0/0/0 0/0/0 0/0/0 0/0/0 0/0/0 0/0/1 0/0/0 0/0/0 0/0/0 0/0/4 0/0/4 0/0/4 0/0/1 0/0/4 0/0/4 0/0/4 0/0/0 0/0/0 0/0/0 0/0/1 0/0/0 0/0/0 0/0/0 0/0/0 0/0/4 0/0/4 0/0/4 0/0/1 0/0/4 0/0/4 0/0/4 0/0/0 0/0/0 0/0/0 0/0/0 0/0/1 0/0/0 0/0/0 0/0/0 0/0/0 0/0/4 0/0/4 0/0/4 0/0/1 0/0/0 0/0/0 0/0/0 0/0/0 0/0/0 0/0/1 0/0/0 0/0/0 0/0/0 0/0/0 0/0/0 1/0/1 0/0/0 0/0/0 0/0/0 0/0/0
0/0/0 0/0/0 0/0/0 0/0/0 1/0/1 0/0/3 0/0/3 0/0/0 0/0/0 0/0/0 0/0/0 0/0/0 0/0/0 0/0/0 0/0/0 0/0/1 0/0/0 0/0/0 0/0/0 0/0/0 0/0/0 0/0/0 0/0/0 0/0/0 0/0/0 0/0/1 0/0/0 0/0/0 0/0/0 0/0/4 0/0/4 0/0/4 0/0/1 0/0/4 0/0/4 0/0/4 0/0/0 0/0/0 0/0/0 0/0/1 0/0/0 0/0/0 0/0/0 0/0/0 0/0/4 0/0/4 0/0/4 0/0/1 0/0/4 0/0/4 0/0/4 0/0/0 0/0/0 0/0/0 0/0/0 0/0/1 0/0/0 0/0/0 0/0/0 0/0/0 0/0/4 0/0/4 0/0/4 0/0/1 0/0/4 0/0/4 0/0/4 0/0/0 0/0/0 0/0/1 0/0/0 0/0/0 0/0/4 0/0/4 0/0/4 1/0/1 0/0/0 0/0/0 0/0/0 0/0/0
0/0/0 0/0/0 0/0/0 0/0/0 1/0/1 1/0/1 1/0/1 1/0/1 1/0/1 1/0/1 1/0/1 1/0/1 1/0/1 1/0/1 1/0/1 1/0/1 1/0/1 1/0/1 1/0/1 1/0/1 1/0/1 1/0/1 1/0/1 1/0/1 1/0/1 1/0/1 1/0/1 1/0/1 1/0/1 1/0/1 1/0/1 1/0/1 1/0/1 1/0/1 1/0/1 1/0/1 1/0/1 1/0/1 1/0/1 1/0/1 1/0/1 1/0/1 1/0/1 1/0/1 1/0/1 1/0/1 1/0/1 1/0/1 1/0/1 1/0/1 1/0/1 1/0/1 1/0/1 1/0/1 1/0/1 1/0/1 1/0/1 1/0/1 1/0/1 1/0/1 1/0/1 1/0/1 1/0/1 1/0/1 1/0/1 1/0/1 1/0/1 1/0/1 1/0/1 1/0/1 1/0/1 1/0/1 1/0/1 1/0/1 1/0/1 1/0/1 0/0/0 0/0/0 0/0/0 0/0/0
0/0/0 0/0/0 0/0/0 0/0/0 0/0/0 0/0/0 0/0/0 0/0/0 0/0/0 0/0/0 0/0/0 0/0/0 0/0/0 0/0/0 0/0/0 0/0/0 0/0/0 0/0/0 0/0/0 0/0/0 0/0/0 0/0/0 0/0/0 0/0/0 0/0/0 0/0/0 0/0/0 0/0/0 0/0/0 0/0/0 0/0/0 0/0/0 0/0/0 0/0/0 0/0/0 0/0/0 0/0/0 0/0/0 0/0/0 0/0/0 0/0/0 0/0/0 0/0/0 0/0/0 0/0/0 0/0/0 0/0/0 0/0/0 0/0/0 0/0/0 0/0/0 0/0/0 0/0/0 0/0/0 0/0/0 0/0/0 0/0/0 0/0/0 0/0/0 0/0/0 0/0/0 0/0/0 0/0/0 0/0/0 0/0/0 0/0/0 0/0/0 0/0/0 0/0/0 0/0/0 0/0/0 0/0/0 0/0/0 0/0/0 0/0/0 0/0/0 0/0/0 0/0/0 0/0/0 0/0/0
1/4/38/75/16/75/17/75/18/75/20/75/19/75/1/34/1/35/1/36/1/37/1/38/1/39/1/40/1/41
