1/0/1 1/0/1 1/0/2 1/0/2 1/0/2 1/0/1 1/0/1 1/0/1 1/0/1 1/0/1 1/0/1 1/0/1 1/0/1 1/0/1 1/0/1 1/0/1 1/0/1 1/0/1 1/0/1 1/0/1 1/0/1 1/0/1 1/0/1 1/0/1 1/0/1 1/0/1 1/0/1 1/0/1 1/0/1 0/0/0
1/0/1 0/0/0 0/0/0 0/0/0 0/0/0 0/0/0 0/0/0 0/0/0 0/0/0 0/0/0 0/0/0 0/0/0 0/0/0 0/0/0 0/0/0 0/0/0 0/0/4 0/0/4 0/0/0 0/0/4 0/0/4 0/0/0 0/0/0 0/0/0 0/0/0 0/0/4 0/0/4 0/0/4 1/0/1 0/0/0
1/0/1 0/0/0 0/0/0 0/0/0 0/0/0 0/0/0 0/0/0 0/0/0 0/0/0 0/0/0 0/0/0 0/0/0 0/0/0 0/0/0 0/0/0 0/0/0 0/0/4 0/0/4 0/0/0 0/0/4 0/0/4 0/0/0 0/0/0 0/0/0 0/0/0 0/0/4 0/0/4 0/0/4 1/0/1 0/0/0
1/0/1 0/0/0 0/0/0 0/0/0 0/0/0 0/0/0 0/0/0 0/0/0 0/0/0 0/0/0 0/0/0 0/0/0 0/0/0 0/0/0 0/0/0 0/0/0 0/0/4 0/0/4 0/0/0 0/0/4 0/0/4 0/0/0 0/0/0 0/0/0 0/0/0 0/0/0 0/0/0 0/0/0 1/0/1 0/0/0
1/0/1 0/0/0 0/0/0 0/0/0 0/0/0 0/0/0 0/0/4 0/0/4 0/0/0 0/0/0 0/0/4 0/0/4 0/0/0 0/0/0 0/0/4 0/0/4 0/0/0 0/0/0 0/0/0 0/0/0 0/0/0 0/0/0 0/0/0 0/0/0 0/0/0 0/0/0 0/0/0 0/0/0 1/0/1 0/0/0
1/0/1 0/0/0 0/0/0 0/0/0 0/0/0 0/0/0 0/0/4 0/0/4 0/0/0 0/0/0 0/0/4 0/0/4 0/0/0 0/0/0 0/0/4 0/0/4 0/0/0 0/0/0 0/0/0 0/0/0 0/0/0 0/0/0 0/0/0 0/0/0 0/0/0 0/0/4 0/0/4 0/0/4 1/0/1 0/0/0
1/0/1 0/0/0 0/0/0 0/0/0 0/0/0 0/0/0 0/0/4 0/0/4 0/0/0 0/0/0 0/0/4 0/0/4 0/0/0 0/0/0 0/0/4 0/0/4 0/0/0 0/0/0 0/0/0 0/0/0 0/0/0 0/0/0 0/0/0 0/0/0 0/0/0 0/0/4 0/0/4 0/0/4 1/0/1 0/0/0
1/0/1 0/0/0 0/0/0 0/0/0 0/0/0 0/0/0 0/0/0 0/0/0 0/0/0 0/0/0 0/0/0 0/0/0 0/0/0 0/0/0 0/0/0 0/0/0 0/0/0 0/0/0 0/0/0 0/0/0 0/0/0 0/0/0 0/0/0 0/0/0 0/0/0 0/0/0 0/0/0 0/0/0 1/0/1 0/0/0
1/0/1 0/0/0 0/0/0 0/0/0 0/0/0 0/0/0 0/0/0 0/0/0 0/0/0 0/0/0 0/0/0 0/0/0 0/0/0 0/0/0 0/0/0 0/0/0 0/0/0 0/0/0 0/0/0 0/0/0 0/0/0 0/0/0 0/0/0 0/0/0 0/0/0 0/0/0 0/0/0 0/0/0 1/0/1 0/0/0
1/0/1 0/0/0 0/0/0 0/0/0 0/0/0 0/0/0 0/0/4 0/0/4 0/0/0 0/0/0 0/0/4 0/0/4 0/0/0 0/0/0 0/0/4 0/0/4 0/0/0 0/0/0 0/0/0 0/0/0 0/0/0 0/0/0 0/0/0 0/0/0 0/0/0 0/0/4 0/0/4 0/0/4 1/0/1 0/0/0
1/0/1 0/0/0 0/0/0 0/0/0 0/0/0 0/0/0 0/0/4 0/0/4 0/0/0 0/0/0 0/0/4 0/0/4 0/0/0 0/0/0 0/0/4 0/0/4 0/0/0 0/0/0 0/0/0 0/0/0 0/0/0 0/0/0 0/0/0 0/0/0 0/0/0 0/0/4 0/0/4 0/0/4 1/0/1 0/0/0
1/0/1 0/0/0 0/0/0 0/0/0 0/0/0 0/0/0 0/0/4 0/0/4 0/0/0 0/0/0 0/0/4 0/0/4 0/0/0 0/0/0 0/0/4 0/0/4 0/0/0 0/0/0 0/0/0 0/0/4 0/0/4 0/0/0 0/0/0 0/0/0 0/0/0 0/0/0 0/0/0 0/0/0 1/0/1 0/0/0
1/0/1 0/0/0 0/0/0 0/0/0 0/0/0 0/0/0 0/0/0 0/0/0 0/0/0 0/0/0 0/0/0 0/0/0 0/0/0 0/0/0 0/0/0 0/0/0 0/0/0 0/0/0 0/0/0 0/0/4 0/0/4 0/0/0 0/0/0 0/0/0 0/0/0 0/0/0 0/0/0 0/0/0 1/0/1 0/0/0
1/0/1 0/0/0 0/0/0 0/0/0 0/0/0 0/0/0 0/0/0 0/0/0 0/0/0 0/0/0 0/0/0 0/0/0 0/0/0 0/0/0 0/0/0 0/0/0 0/0/0 0/0/0 0/0/0 0/0/4 0/0/4 0/0/0 0/0/0 0/0/0 0/0/0 0/0/0 0/0/0 0/0/0 1/0/1 0/0/0
1/0/1 1/0/1 1/0/1 1/0/1 1/0/1 1/0/1 1/0/1 1/0/1 1/0/1 1/0/1 1/0/1 1/0/1 1/0/1 1/0/1 1/0/1 1/0/1 1/0/1 1/0/1 1/0/1 1/0/1 1/0/1 1/0/1 1/0/1 1/0/1 1/0/1 1/0/1 1/0/1 1/0/1 1/0/1 0/0/0
0_0-14_28/0/78/0_2-0_3-0_4